product_area,location_country,supplier_name,location_region,onboard_date_v2,sla_end_to_end_exclude_weekend1,wo_adv_std_include_weekend,complaince_activation_exclude_weekend,xws_activation_to_idv,xws_idv_to_system_activation
Technical Infrastructure,Thailand,WOOD INTERNATIONAL LIMITED,APAC,2025-04-28,3,2,1,0,1
Technical Infrastructure,Australia,MSS SECURITY PTY LTD,APAC,2025-04-22,5,1,4,0,4
REWS,India,COMPASS GROUP PLC,APAC,2025-04-25,2,2,0,0,0
REWS,United States,ISS A/S,NORTH AMERICA,2025-04-29,3,5,0,0,0
Devices & Services,United States,ARCLIGHT WIRELESS INC,NORTH AMERICA,2025-04-25,7,6,3,1,2
gTech,India,TELEPERFORMANCE SE,APAC,2025-04-28,4,6,0,0,0
REWS,India,JONES LANG LASALLE INC,APAC,2025-05-02,3,3,0,0,0
gTech,Poland,TELEPERFORMANCE SE,EMEA,2025-04-28,3,5,0,0,0
gCS,India,REGALIX INC,APAC,2025-04-24,3,3,0,0,0
POps,Mexico,PWC,LATAM,2025-04-23,9,5,6,0,6
Technical Infrastructure,United States,VISION TECHNOLOGIES INC.,NORTH AMERICA,2025-04-30,4,6,0,0,0
POps,India,RANDSTAD NV,APAC,2025-04-29,10,1,9,0,9
Devices & Services,India,TECH MAHINDRA LIMITED,APAC,2025-04-28,9,1,8,0,8
Technical Infrastructure,United States,SCHENKER,NORTH AMERICA,2025-04-28,9,3,6,5,1
T&S,India,COGNIZANT TECHNOLOGY SOLUTIONS CORPORATION,APAC,2025-04-23,2,1,1,0,1
REWS,Poland,COMPASS GROUP PLC,EMEA,2025-04-24,14,14,4,1,3
Access,United States,PEARCE SERVICES LLC,NORTH AMERICA,2025-04-23,3,4,1,0,1
T&S,India,WIPRO LIMITED,APAC,2025-04-23,1,1,0,0,0
Technical Infrastructure,United States,GXO LOGISTICS WORLDWIDE LLC,NORTH AMERICA,2025-04-22,3,4,1,1,0
Cloud,Mexico,TATA GROUP,LATAM,2025-04-29,13,7,8,7,1
Cloud,El Salvador,TELUS,LATAM,2025-04-30,2,2,0,0,0
T&S,India,COGNIZANT TECHNOLOGY SOLUTIONS CORPORATION,APAC,2025-04-23,2,1,1,0,1
Waymo,Philippines,COGNIZANT TECHNOLOGY SOLUTIONS CORPORATION,APAC,2025-04-21,5,2,3,3,0
T&S,Costa Rica,TELEPERFORMANCE SE,LATAM,2025-04-22,8,5,5,4,1
gTech,India,TECH MAHINDRA LIMITED,APAC,2025-04-27,3,2,1,1,0
Cloud,India,COGNIZANT TECHNOLOGY SOLUTIONS CORPORATION,APAC,2025-04-25,3,3,0,0,0
Geo,Poland,COGNIZANT TECHNOLOGY SOLUTIONS CORPORATION,EMEA,2025-04-22,5,6,1,1,0
YouTube,India,CONCENTRIX,APAC,2025-04-24,2,1,1,0,1
Ads & Commerce,India,GLOBALLOGIC INC,APAC,2025-05-02,4,3,1,1,0
Waymo,United States,TRANSDEV,NORTH AMERICA,2025-05-01,7,2,5,0,5
Search,India,GLOBALLOGIC INC,APAC,2025-05-02,3,3,0,0,0
REWS,Spain,PROSEGUR SA,EMEA,2025-04-22,4,1,3,2,1
Waymo,India,WIPRO LIMITED,APAC,2025-04-24,3,2,2,2,0
HUE,Australia,SCALENCE LLC,APAC,2025-04-28,5,2,3,1,2
Geo,India,ACCENTURE PLC,APAC,2025-05-02,6,5,3,2,1
gTech,Philippines,TELUS,APAC,2025-04-22,1,1,0,0,0
Cloud,El Salvador,TELUS,LATAM,2025-05-02,4,4,0,0,0
gTech,United States,VACO,NORTH AMERICA,2025-04-21,3,5,0,0,0
Technical Infrastructure,Indonesia,G4S PLC,APAC,2025-04-24,3,4,0,0,0
YouTube,Malaysia,CONCENTRIX,APAC,2025-04-30,5,1,4,0,4
Waymo,India,WIPRO LIMITED,APAC,2025-04-28,3,2,1,0,1
Cloud,Mexico,TATA GROUP,LATAM,2025-04-24,2,2,0,0,0
YouTube,India,CONCENTRIX,APAC,2025-04-24,4,4,2,0,2
T&S,India,ACCENTURE PLC,APAC,2025-04-25,3,1,2,0,2
Technical Infrastructure,null,"HOLDER CONSTRUCTION GROUP, LLC",NORTH AMERICA,2025-04-23,3,5,0,0,0
Geo,India,WIPRO LIMITED,APAC,2025-04-25,1,1,0,0,0
Devices & Services,India,QUEST GLOBAL SERVICES PTE. LTD.,APAC,2025-04-22,4,6,0,0,0
Technical Infrastructure,Malaysia,JONES LANG LASALLE INC,APAC,2025-04-21,5,3,2,0,2
Finance,Philippines,ACCENTURE PLC,APAC,2025-04-22,12,4,10,0,10
YouTube,India,ACCENTURE PLC,APAC,2025-05-02,6,4,4,0,4
Cloud,India,INFOSYS,APAC,2025-04-30,2,1,1,0,1
Waymo,India,WIPRO LIMITED,APAC,2025-05-01,3,2,1,0,1
REWS,India,JONES LANG LASALLE INC,APAC,2025-05-02,3,3,0,0,0
YouTube,Malaysia,CONCENTRIX,APAC,2025-04-21,7,4,5,0,5
Geo,India,WIPRO LIMITED,APAC,2025-04-29,3,6,0,0,0
REWS,India,JONES LANG LASALLE INC,APAC,2025-04-23,2,2,0,0,0
gTech,India,COGNIZANT TECHNOLOGY SOLUTIONS CORPORATION,APAC,2025-04-25,3,2,1,0,1
REWS,null,COMPASS GROUP PLC,APAC,2025-04-21,3,5,0,0,0
YouTube,India,GENPACT LIMITED,APAC,2025-04-28,3,1,2,0,2
REWS,Finland,CBRE GROUP INC,EMEA,2025-05-02,3,3,0,0,0
POps,India,RANDSTAD NV,APAC,2025-05-02,7,2,5,0,5
Cloud,United States,THE BOSTON CONSULTING GROUP INC,NORTH AMERICA,2025-05-02,12,5,9,1,8
Cloud,Brazil,TTEC HOLDINGS INC,LATAM,2025-04-24,7,2,5,5,0
YouTube,Malaysia,ACCENTURE PLC,APAC,2025-04-28,3,2,1,1,0
Technical Infrastructure,United Kingdom,SUDLOWS ENTERPRISE SERVICES LIMITED,EMEA,2025-05-02,3,3,0,0,0
Waymo,India,WIPRO LIMITED,APAC,2025-04-30,2,1,1,1,0
REWS,United States,MC DEAN INC,NORTH AMERICA,2025-04-24,7,1,6,6,0
Cloud,India,ACCENTURE PLC,APAC,2025-04-22,12,6,8,2,6
T&S,Ireland,ACCENTURE PLC,EMEA,2025-04-23,4,5,1,1,0
Technical Infrastructure,null,C D MOODY CONSTRUCTION COMPANY INC,NORTH AMERICA,2025-04-25,3,3,0,0,0
Devices & Services,United States,"CADENCE DESIGN SYSTEMS, INC.",NORTH AMERICA,2025-05-02,5,5,2,0,2
Technical Infrastructure,United States,VEEAR PROJECTS INC,NORTH AMERICA,2025-04-29,6,1,5,2,3
Cloud,El Salvador,TELUS,LATAM,2025-05-02,4,3,1,1,0
REWS,United States,JONES LANG LASALLE INC,NORTH AMERICA,2025-04-21,3,2,1,0,1
POps,India,DELOITTE,APAC,2025-04-29,3,5,0,0,0
YouTube,India,ACCENTURE PLC,APAC,2025-04-27,10,1,9,8,1
POps,India,RANDSTAD NV,APAC,2025-04-25,11,null,11,1,10
Technical Infrastructure,United States,GXO LOGISTICS WORLDWIDE LLC,NORTH AMERICA,2025-05-01,7,3,4,1,3
Technical Infrastructure,India,ACCENTURE PLC,APAC,2025-04-23,8,3,7,0,7
Technical Infrastructure,India,ACCENTURE PLC,APAC,2025-05-02,7,2,5,2,3
Corp Eng,India,COGNIZANT TECHNOLOGY SOLUTIONS CORPORATION,APAC,2025-04-27,4,1,3,3,0
Cloud,Spain,TELEPERFORMANCE SE,EMEA,2025-04-28,3,5,0,0,0
Technical Infrastructure,Finland,FIBER HIGHWAY FINLAND OY,EMEA,2025-04-24,2,1,1,0,1
gTech,India,CONCENTRIX,APAC,2025-04-29,5,3,2,2,0
Technical Infrastructure,United States,THE WHITING TURNER CONTRACTING COMPANY,NORTH AMERICA,2025-04-22,3,5,0,0,0
Technical Infrastructure,United States,MILESTONE TECHNOLOGIES INC,NORTH AMERICA,2025-04-21,6,5,3,3,0
Waymo,India,WIPRO LIMITED,APAC,2025-04-27,5,2,4,0,4
REWS,Canada,COMPASS GROUP PLC,NORTH AMERICA,2025-04-28,4,6,0,0,0
Cloud,India,DELOITTE,APAC,2025-04-24,4,3,3,1,2
T&S,India,WIPRO LIMITED,APAC,2025-04-21,4,1,3,1,2
Technical Infrastructure,United States,GXO LOGISTICS WORLDWIDE LLC,NORTH AMERICA,2025-04-25,21,4,19,14,5
Technical Infrastructure,United States,GXO LOGISTICS WORLDWIDE LLC,NORTH AMERICA,2025-04-28,2,4,0,0,0
Marketing,United States,"US TECH SOLUTIONS, INC.",NORTH AMERICA,2025-04-30,9,18,7,6,1
Waymo,India,WIPRO LIMITED,APAC,2025-04-29,4,2,2,2,0
REWS,United States,GARDA WORLD SECURITY CORPORATION,NORTH AMERICA,2025-04-22,2,3,1,0,1
gCS,India,ACCENTURE PLC,APAC,2025-04-29,5,1,4,4,0
Cloud,United States,MEDIATEK INC,NORTH AMERICA,2025-04-29,18,5,15,14,1
T&S,Philippines,ACCENTURE PLC,APAC,2025-04-23,11,2,9,8,1
Technical Infrastructure,United States,GXO LOGISTICS WORLDWIDE LLC,NORTH AMERICA,2025-04-25,3,2,1,1,0
YouTube,India,ACCENTURE PLC,APAC,2025-04-22,9,1,8,0,8
gTech,Japan,ACCENTURE PLC,APAC,2025-04-21,5,3,2,0,2
REWS,Brazil,SODEXO,LATAM,2025-05-02,3,3,0,0,0
REWS,India,JONES LANG LASALLE INC,APAC,2025-04-22,1,1,0,0,0
Cloud,India,DELOITTE,APAC,2025-04-24,5,5,2,2,0
YouTube,Portugal,COGNIZANT TECHNOLOGY SOLUTIONS CORPORATION,EMEA,2025-04-22,6,2,4,3,1
gCS,Philippines,CONCENTRIX,APAC,2025-04-30,2,2,0,0,0
gTech,India,TELEPERFORMANCE SE,APAC,2025-04-21,4,1,3,1,2
REWS,Japan,VECTOR RISK MANAGEMENT KK,APAC,2025-04-30,5,5,2,0,2
REWS,Australia,CSE CROSSCOM PTY LTD,APAC,2025-04-28,22,1,21,4,17
Devices & Services,India,HCL TECHNOLOGIES LTD,APAC,2025-04-24,2,2,0,0,0
gTech,Greece,TELEPERFORMANCE SE,EMEA,2025-04-23,4,1,3,2,1
gTech,India,TECH MAHINDRA LIMITED,APAC,2025-04-24,1,1,0,0,0
T&S,India,WIPRO LIMITED,APAC,2025-04-22,5,1,4,4,0
Technical Infrastructure,United States,GXO LOGISTICS WORLDWIDE LLC,NORTH AMERICA,2025-04-24,2,2,0,0,0
gTech,Poland,TELEPERFORMANCE SE,EMEA,2025-04-29,4,6,0,0,0
Ads & Commerce,Poland,TELUS,EMEA,2025-04-28,2,4,0,0,0
Geo,India,WIPRO LIMITED,APAC,2025-04-28,2,4,0,0,0
T&S,India,ACCENTURE PLC,APAC,2025-04-25,4,2,2,0,2
Finance,United States,"DEXIAN, LLC",NORTH AMERICA,2025-04-27,17,9,13,0,13
Core (w/o Corp Eng),India,HCL TECHNOLOGIES LTD,APAC,2025-04-21,6,5,3,0,3
DeepMind,United States,SCALE AI INC,NORTH AMERICA,2025-04-25,20,3,19,8,11
T&S,India,CONCENTRIX,APAC,2025-04-21,3,2,1,1,0
gCS,Spain,TELEPERFORMANCE SE,EMEA,2025-04-23,19,5,16,5,11
Technical Infrastructure,United States,GARDA WORLD SECURITY CORPORATION,NORTH AMERICA,2025-05-01,3,3,0,0,0
Geo,India,WIPRO LIMITED,APAC,2025-04-29,3,4,1,0,1
Corp Eng,India,ACCENTURE PLC,APAC,2025-04-24,1,1,0,0,0
Cloud,India,CAPGEMINI SE,APAC,2025-04-21,14,1,13,0,13
YouTube,India,CONCENTRIX,APAC,2025-04-21,2,1,1,1,0
Technical Infrastructure,null,INTEGRITY CONCEPTS LLC,NORTH AMERICA,2025-04-29,3,5,0,0,0
gTech,India,TECH MAHINDRA LIMITED,APAC,2025-04-27,3,2,1,0,1
Technical Infrastructure,null,SCHENKER,NORTH AMERICA,2025-04-25,3,3,0,0,0
Technical Infrastructure,Finland,FIBER HIGHWAY FINLAND OY,EMEA,2025-04-28,4,1,3,0,3
Technical Infrastructure,United States,SCHENKER,NORTH AMERICA,2025-04-27,5,4,1,0,1
Technical Infrastructure,United States,SYNCREON GLOBAL HOLDINGS LIMITED,NORTH AMERICA,2025-04-22,3,1,2,2,0
Technical Infrastructure,United States,ALLISON SMITH CO LLC,NORTH AMERICA,2025-04-23,5,5,2,2,0
Technical Infrastructure,Indonesia,G4S PLC,APAC,2025-04-21,5,4,2,2,0
REWS,India,SODEXO,APAC,2025-04-22,1,1,0,0,0
Waymo,India,WIPRO LIMITED,APAC,2025-05-01,3,1,2,2,0
Technical Infrastructure,null,ALPHA SERVICES CORPORATION,NORTH AMERICA,2025-04-21,3,5,0,0,0
gCS,India,ACCENTURE PLC,APAC,2025-04-24,7,2,5,3,2
gCS,Canada,TELEPERFORMANCE SE,NORTH AMERICA,2025-04-30,5,1,4,2,2
REWS,United States,PROPARK AMERICA WEST LLC,NORTH AMERICA,2025-04-28,2,4,0,0,0
REWS,null,SODEXO,APAC,2025-05-02,3,3,0,0,0
Waymo,India,COGNIZANT TECHNOLOGY SOLUTIONS CORPORATION,APAC,2025-04-23,1,1,0,0,0
YouTube,India,GENPACT LIMITED,APAC,2025-04-28,3,2,1,1,0
REWS,Singapore,JONES LANG LASALLE INC,APAC,2025-05-01,7,6,3,3,0
Technical Infrastructure,Netherlands,SCHENKER,EMEA,2025-04-22,4,2,2,0,2
REWS,India,G4S PLC,APAC,2025-04-24,1,1,0,0,0
Technical Infrastructure,United States,GXO LOGISTICS WORLDWIDE LLC,NORTH AMERICA,2025-04-22,3,5,0,0,0
Cloud,India,ACCENTURE PLC,APAC,2025-04-22,8,4,6,1,5
REWS,Romania,SECURITAS AB,EMEA,2025-04-28,4,6,0,0,0
Technical Infrastructure,null,"HOLDER CONSTRUCTION GROUP, LLC",NORTH AMERICA,2025-05-01,3,3,0,0,0
gTech,Germany,VACO,EMEA,2025-04-21,3,5,0,0,0
Technical Infrastructure,United States,GARDA WORLD SECURITY CORPORATION,NORTH AMERICA,2025-04-25,4,1,3,1,2
Corp Eng,India,DELOITTE,APAC,2025-04-24,3,2,1,0,1
Cloud,United States,DELOITTE,NORTH AMERICA,2025-04-28,7,1,6,0,6
YouTube,Portugal,GENPACT LIMITED,EMEA,2025-04-30,7,3,4,2,2
T&S,India,WIPRO LIMITED,APAC,2025-04-28,4,1,3,0,3
Devices & Services,null,TESSOLVE SEMICONDUCTOR PVT LTD,APAC,2025-04-28,3,5,0,0,0
Platforms + Ecosystems,null,QUEST GLOBAL SERVICES PTE. LTD.,NORTH AMERICA,2025-04-29,3,5,0,0,0
gCS,Brazil,TTEC HOLDINGS INC,LATAM,2025-05-02,9,8,3,3,0
gTech,India,COGNIZANT TECHNOLOGY SOLUTIONS CORPORATION,APAC,2025-05-01,3,3,0,0,0
REWS,India,JONES LANG LASALLE INC,APAC,2025-04-24,3,3,0,0,0
Access,United States,IBEX HOLDINGS LIMITED,NORTH AMERICA,2025-04-22,3,1,2,0,2
Technical Infrastructure,United States,C D MOODY CONSTRUCTION COMPANY INC,NORTH AMERICA,2025-04-24,3,3,0,0,0
T&S,Philippines,ACCENTURE PLC,APAC,2025-04-29,5,3,2,0,2
Cloud,Romania,COGNIZANT TECHNOLOGY SOLUTIONS CORPORATION,EMEA,2025-05-01,5,4,3,2,1
Technical Infrastructure,United States,GARDA WORLD SECURITY CORPORATION,NORTH AMERICA,2025-05-01,13,10,5,1,4
Geo,India,ACCENTURE PLC,APAC,2025-05-02,6,5,3,1,2
Technical Infrastructure,Finland,ADECCO GROUP AG,EMEA,2025-04-23,7,7,2,0,2
Technical Infrastructure,Japan,"EXECUTIVE PROTECTION, INC.",APAC,2025-04-25,1,1,0,0,0
Waymo,India,COGNIZANT TECHNOLOGY SOLUTIONS CORPORATION,APAC,2025-05-02,4,3,1,1,0
T&S,India,WIPRO LIMITED,APAC,2025-05-01,6,1,5,4,1
YouTube,Philippines,TECH MAHINDRA LIMITED,APAC,2025-05-02,11,4,9,0,9
gCS,India,REGALIX INC,APAC,2025-04-23,2,2,0,0,0
Finance,India,KPMG,APAC,2025-04-24,3,1,2,0,2
Technical Infrastructure,United States,AMENTUM COMMERCIAL OPERATIONS INC,NORTH AMERICA,2025-04-24,3,2,1,1,0
Technical Infrastructure,United States,SCHENKER,NORTH AMERICA,2025-04-25,4,4,0,0,0
gTech,India,COGNIZANT TECHNOLOGY SOLUTIONS CORPORATION,APAC,2025-04-30,4,6,0,0,0
Devices & Services,United States,SIEMENS AG,NORTH AMERICA,2025-04-25,6,1,5,1,4
Technical Infrastructure,United States,ALLIED UNIVERSAL,NORTH AMERICA,2025-04-21,6,10,0,0,0
HUE,United States,"MAGNIT, LLC",NORTH AMERICA,2025-04-21,14,27,0,0,0
gTech,India,TECH MAHINDRA LIMITED,APAC,2025-04-27,3,2,1,0,1
Geo,India,ACCENTURE PLC,APAC,2025-04-25,4,2,2,2,0
gCS,India,TELEDIRECT PTE LTD,APAC,2025-04-29,5,2,3,2,1
T&S,India,WIPRO LIMITED,APAC,2025-04-21,6,3,5,5,0
REWS,Australia,WOODS BAGOT PTY. LTD.,APAC,2025-04-22,8,1,7,1,6
Technical Infrastructure,null,"HOLDER CONSTRUCTION GROUP, LLC",NORTH AMERICA,2025-04-25,3,3,0,0,0
POps,India,RANDSTAD NV,APAC,2025-04-25,8,3,5,4,1
REWS,Finland,CBRE GROUP INC,EMEA,2025-05-02,3,3,0,0,0
Waymo,India,COGNIZANT TECHNOLOGY SOLUTIONS CORPORATION,APAC,2025-04-21,1,3,0,0,0
T&S,India,ACCENTURE PLC,APAC,2025-04-28,5,2,3,0,3
Technical Infrastructure,United States,GXO LOGISTICS WORLDWIDE LLC,NORTH AMERICA,2025-04-24,2,2,0,0,0
REWS,India,JONES LANG LASALLE INC,APAC,2025-04-22,1,1,0,0,0
YouTube,India,ACCENTURE PLC,APAC,2025-04-21,6,3,5,0,5
POps,India,RANDSTAD NV,APAC,2025-04-28,12,5,9,0,9
REWS,India,COMPASS GROUP PLC,APAC,2025-04-21,3,5,0,0,0
Cloud,Philippines,ACCENTURE PLC,APAC,2025-04-23,6,2,4,3,1
Ads & Commerce,India,GLOBALLOGIC INC,APAC,2025-04-27,5,1,4,2,2
REWS,India,JAGUAR SECURITY SERVICES PVT. LTD.,APAC,2025-04-23,1,1,0,0,0
Technical Infrastructure,United States,"HOLDER CONSTRUCTION GROUP, LLC",NORTH AMERICA,2025-04-24,4,6,0,0,0
YouTube,Philippines,CONCENTRIX,APAC,2025-04-22,7,5,4,3,1
gCS,India,TELEDIRECT PTE LTD,APAC,2025-05-02,9,3,6,4,2
T&S,India,WIPRO LIMITED,APAC,2025-04-25,3,1,2,0,2
Cloud,Philippines,ACCENTURE PLC,APAC,2025-04-23,6,3,3,2,1
Cloud,India,HCL TECHNOLOGIES LTD,APAC,2025-04-21,4,2,2,2,0
POps,India,COGNIZANT TECHNOLOGY SOLUTIONS CORPORATION,APAC,2025-04-28,1,3,0,0,0
Finance,United States,ERNST AND YOUNG LLP,NORTH AMERICA,2025-04-25,6,1,5,1,4
Waymo,India,WIPRO LIMITED,APAC,2025-04-24,3,4,0,0,0
Technical Infrastructure,United States,GXO LOGISTICS WORLDWIDE LLC,NORTH AMERICA,2025-05-02,6,5,3,3,0
Technical Infrastructure,United States,ALLIED UNIVERSAL,NORTH AMERICA,2025-05-02,3,3,0,0,0
gCS,India,REGALIX INC,APAC,2025-04-23,2,2,0,0,0
T&S,Portugal,ACCENTURE PLC,EMEA,2025-04-30,11,1,10,1,9
Devices & Services,India,HCL TECHNOLOGIES LTD,APAC,2025-04-30,2,3,0,0,0
Technical Infrastructure,United States,GARDA WORLD SECURITY CORPORATION,NORTH AMERICA,2025-04-23,11,1,10,10,0
REWS,India,SODEXO,APAC,2025-05-02,3,3,0,0,0
gCS,India,WNS (HOLDINGS) LIMITED,APAC,2025-04-28,5,3,2,2,0
T&S,India,WIPRO LIMITED,APAC,2025-04-28,4,2,2,0,2
T&S,India,ACCENTURE PLC,APAC,2025-04-21,6,3,5,0,5
REWS,Canada,JOHNSON CONTROLS INTERNATIONAL PLC,NORTH AMERICA,2025-04-23,3,5,0,0,0
Waymo,India,COGNIZANT TECHNOLOGY SOLUTIONS CORPORATION,APAC,2025-04-21,1,3,0,0,0
REWS,null,COMPASS GROUP PLC,APAC,2025-04-28,3,5,0,0,0
T&S,India,WIPRO LIMITED,APAC,2025-05-01,4,5,1,0,1
Research,United States,A.G. KUNZ LLC,NORTH AMERICA,2025-04-22,10,2,8,7,1
Cloud,El Salvador,TELUS,LATAM,2025-05-02,4,3,1,1,0
T&S,Philippines,ACCENTURE PLC,APAC,2025-04-24,8,1,7,7,0
T&S,India,WIPRO LIMITED,APAC,2025-05-02,4,1,3,0,3
Devices & Services,United States,DELOITTE,NORTH AMERICA,2025-04-30,11,3,8,2,6
REWS,India,SIMPLIWORK OFFICES PRIVATE LIMITED,APAC,2025-04-22,1,1,0,0,0
Access,United States,"ALAN PLUMMER ASSOCIATES, INC",NORTH AMERICA,2025-04-30,12,3,9,2,7
T&S,India,WIPRO LIMITED,APAC,2025-04-30,5,5,2,0,2
Cloud,Philippines,ACCENTURE PLC,APAC,2025-04-24,5,1,4,3,1
Ads & Commerce,India,TELEPERFORMANCE SE,APAC,2025-04-23,5,null,5,1,4
Technical Infrastructure,India,ERICSSON INC,APAC,2025-04-28,1,3,0,0,0
gCS,Brazil,ATENTO S.A.,LATAM,2025-04-29,3,5,0,0,0
REWS,India,JONES LANG LASALLE INC,APAC,2025-04-22,1,1,0,0,0
REWS,India,SODEXO,APAC,2025-05-02,3,3,0,0,0
REWS,India,COMPASS GROUP PLC,APAC,2025-04-28,3,5,0,0,0
Waymo,India,COGNIZANT TECHNOLOGY SOLUTIONS CORPORATION,APAC,2025-04-30,2,2,0,0,0
Waymo,India,WIPRO LIMITED,APAC,2025-04-24,3,4,0,0,0
Waymo,United States,TRANSDEV,NORTH AMERICA,2025-04-25,8,2,6,0,6
Cloud,El Salvador,TELUS,LATAM,2025-04-24,10,13,1,0,1
Waymo,United States,"TASKUS, INC.",NORTH AMERICA,2025-04-22,5,3,2,1,1
YouTube,India,CONCENTRIX,APAC,2025-04-21,3,2,1,0,1
Cloud,India,HCL TECHNOLOGIES LTD,APAC,2025-04-23,1,1,0,0,0
Access,United States,DYCOM INDUSTRIES,NORTH AMERICA,2025-04-28,10,4,7,7,0
Cloud,Greece,TELEPERFORMANCE SE,EMEA,2025-04-29,3,5,0,0,0
gTech,United States,VACO,NORTH AMERICA,2025-04-22,4,1,3,0,3
Technical Infrastructure,null,"HOLDER CONSTRUCTION GROUP, LLC",NORTH AMERICA,2025-04-23,3,5,0,0,0
T&S,India,WIPRO LIMITED,APAC,2025-04-30,3,5,0,0,0
gTech,Greece,TELEPERFORMANCE SE,EMEA,2025-04-30,5,5,2,1,1
Cloud,United States,ACCENTURE PLC,NORTH AMERICA,2025-05-01,4,5,1,1,0
Technical Infrastructure,United States,DIRECT LINE GLOBAL LLC,NORTH AMERICA,2025-04-23,2,2,0,0,0
gTech,Poland,COGNIZANT TECHNOLOGY SOLUTIONS CORPORATION,EMEA,2025-05-02,4,2,2,0,2
gCS,India,WNS (HOLDINGS) LIMITED,APAC,2025-04-23,2,1,1,1,0
Geo,India,WIPRO LIMITED,APAC,2025-04-29,3,4,1,0,1
Cloud,India,HCL TECHNOLOGIES LTD,APAC,2025-05-02,3,3,0,0,0
gTech,India,TELEPERFORMANCE SE,APAC,2025-04-21,5,3,2,2,0
Technical Infrastructure,Indonesia,G4S PLC,APAC,2025-04-23,2,3,0,0,0
YouTube,India,GENPACT LIMITED,APAC,2025-04-28,3,2,1,0,1
YouTube,India,ACCENTURE PLC,APAC,2025-04-21,6,4,4,0,4
Technical Infrastructure,Netherlands,SYNCREON GLOBAL HOLDINGS LIMITED,EMEA,2025-04-24,2,1,1,1,0
POps,United States,RANDSTAD NV,NORTH AMERICA,2025-04-29,7,7,2,1,1
gTech,Colombia,CONCENTRIX,LATAM,2025-04-23,2,2,0,0,0
POps,Denmark,WIPRO LIMITED,EMEA,2025-05-02,3,3,0,0,0
Waymo,United States,COGNIZANT TECHNOLOGY SOLUTIONS CORPORATION,NORTH AMERICA,2025-04-28,4,3,1,0,1
Devices & Services,India,HCL TECHNOLOGIES LTD,APAC,2025-04-28,5,3,2,0,2
Technical Infrastructure,null,EVERGREEN JANITORIAL SERVICES INC,NORTH AMERICA,2025-04-25,3,3,0,0,0
T&S,India,WIPRO LIMITED,APAC,2025-04-25,4,3,1,0,1
GBO (w/o gTech & gCS),United States,TIER1 IMPACT PBC INC DBA TIER1 PERFORMANCE,NORTH AMERICA,2025-04-22,3,4,1,1,0
REWS,United Kingdom,247 NATIONAL LIMITED,EMEA,2025-04-22,9,2,7,0,7
Technical Infrastructure,United States,"T5 DCMC, LLC",NORTH AMERICA,2025-04-28,2,4,0,0,0
Technical Infrastructure,United States,DIRECT LINE GLOBAL LLC,NORTH AMERICA,2025-04-24,1,1,0,0,0
Finance,United States,IBM CORPORATION,NORTH AMERICA,2025-04-24,13,4,9,0,9
Cloud,United States,PYRAMID CONSULTING INC.,NORTH AMERICA,2025-04-25,7,4,5,5,0
REWS,United States,JONES LANG LASALLE INC,NORTH AMERICA,2025-05-02,12,5,9,8,1
YouTube,India,ACCENTURE PLC,APAC,2025-04-27,7,1,6,1,5
Technical Infrastructure,null,"HOLDER CONSTRUCTION GROUP, LLC",NORTH AMERICA,2025-04-23,3,5,0,0,0
Technical Infrastructure,United States,ACCENTURE PLC,NORTH AMERICA,2025-04-21,4,6,0,0,0
Waymo,United States,MOOVE US LLC,NORTH AMERICA,2025-04-25,3,3,0,0,0
YouTube,India,ACCENTURE PLC,APAC,2025-04-29,8,6,4,3,1
Technical Infrastructure,United States,GXO LOGISTICS WORLDWIDE LLC,NORTH AMERICA,2025-04-24,7,2,5,5,0
REWS,India,JONES LANG LASALLE INC,APAC,2025-04-24,2,2,0,0,0
GBO (w/o gTech & gCS),Spain,MASH BRANDS PTY LTD,EMEA,2025-04-21,5,3,2,2,0
Access,United States,DYCOM INDUSTRIES,NORTH AMERICA,2025-04-23,4,4,2,1,1
Technical Infrastructure,United States,J E DUNN CONSTRUCTION COMPANY,NORTH AMERICA,2025-04-24,1,1,0,0,0
Geo,United States,TECH MAHINDRA LIMITED,NORTH AMERICA,2025-04-23,5,5,2,2,0
T&S,Philippines,ACCENTURE PLC,APAC,2025-05-02,3,3,0,0,0
Access,United States,TPRC BROADBAND,NORTH AMERICA,2025-04-25,19,8,13,0,13
Waymo,India,COGNIZANT TECHNOLOGY SOLUTIONS CORPORATION,APAC,2025-04-21,1,3,0,0,0
Cloud,El Salvador,SERVICESOURCE INTERNATIONAL INC,LATAM,2025-04-29,3,5,0,0,0
Technical Infrastructure,United States,SCHENKER,NORTH AMERICA,2025-05-02,3,3,0,0,0
Technical Infrastructure,Thailand,JONES LANG LASALLE INC,APAC,2025-04-25,16,4,14,13,1
YouTube,India,ACCENTURE PLC,APAC,2025-04-21,7,4,5,0,5
Geo,India,ACCENTURE PLC,APAC,2025-04-21,18,6,14,1,13
Cloud,United States,MANTECH ADVANCED SYSTEMS INTERNATIONAL INC,NORTH AMERICA,2025-04-22,17,5,14,0,14
Finance,United States,DELOITTE,NORTH AMERICA,2025-04-29,2,4,0,0,0
POps,China,ACCENTURE PLC,APAC,2025-04-28,19,1,18,18,0
T&S,India,WIPRO LIMITED,APAC,2025-04-30,5,7,0,0,0
Technical Infrastructure,United States,SCHENKER,NORTH AMERICA,2025-04-28,4,2,2,1,1
T&S,null,ACCENTURE PLC,EMEA,2025-04-23,3,5,0,0,0
REWS,India,JONES LANG LASALLE INC,APAC,2025-04-21,4,6,0,0,0
YouTube,India,ACCENTURE PLC,APAC,2025-05-02,6,4,4,0,4
Technical Infrastructure,India,ACCENTURE PLC,APAC,2025-04-29,2,3,1,0,1
gCS,India,ACCENTURE PLC,APAC,2025-04-21,8,2,6,6,0
gTech,Philippines,ACCENTURE PLC,APAC,2025-04-29,3,5,0,0,0
YouTube,Malaysia,ACCENTURE PLC,APAC,2025-04-28,3,2,1,1,0
Technical Infrastructure,United Kingdom,SYNERGY SECURITY SOLUTIONS LIMITED,EMEA,2025-04-23,4,4,2,1,1
Technical Infrastructure,United States,SCHENKER,NORTH AMERICA,2025-05-02,5,5,2,0,2
Devices & Services,India,SMOLLAN GROUP SA PTY LTD,APAC,2025-05-01,4,3,3,0,3
REWS,India,G4S PLC,APAC,2025-04-28,3,1,2,2,0
Waymo,Philippines,COGNIZANT TECHNOLOGY SOLUTIONS CORPORATION,APAC,2025-04-28,3,5,0,0,0
T&S,India,WIPRO LIMITED,APAC,2025-04-28,4,2,2,0,2
Waymo,United States,"TASKUS, INC.",NORTH AMERICA,2025-04-28,5,3,2,1,1
Cloud,El Salvador,TELUS,LATAM,2025-04-23,4,5,1,0,1
gTech,India,ACCENTURE PLC,APAC,2025-04-23,2,1,1,0,1
T&S,Philippines,ACCENTURE PLC,APAC,2025-04-24,2,1,1,0,1
gCS,Brazil,TTEC HOLDINGS INC,LATAM,2025-04-30,7,4,3,3,0
Corp Eng,India,MOVATE TECHNOLOGIES PRIVATE LIMITED,APAC,2025-04-25,4,2,2,0,2
REWS,Singapore,AEA INTERNATIONAL HOLDINGS PTE LTD,APAC,2025-04-22,2,3,1,0,1
REWS,null,JONES LANG LASALLE INC,APAC,2025-04-24,3,3,0,0,0
Technical Infrastructure,United States,DIRECT LINE GLOBAL LLC,NORTH AMERICA,2025-04-22,2,3,1,0,1
Devices & Services,Taiwan,TATA GROUP,APAC,2025-05-02,6,4,4,1,3
YouTube,India,ACCENTURE PLC,APAC,2025-04-22,9,2,7,4,3
Waymo,United States,TRANSDEV,NORTH AMERICA,2025-05-02,8,3,5,2,3
gTech,Colombia,CONCENTRIX,LATAM,2025-04-25,2,2,0,0,0
Technical Infrastructure,India,ACCENTURE PLC,APAC,2025-05-02,5,4,3,3,0
Waymo,United States,KPMG,NORTH AMERICA,2025-04-28,2,4,0,0,0
REWS,null,SODEXO,APAC,2025-04-28,3,5,0,0,0
Technical Infrastructure,India,ERICSSON INC,APAC,2025-04-29,3,5,0,0,0
REWS,India,SODEXO,APAC,2025-04-24,3,3,0,0,0
Technical Infrastructure,United States,"HOLDER CONSTRUCTION GROUP, LLC",NORTH AMERICA,2025-05-01,3,3,0,0,0
Technical Infrastructure,Mexico,ASTREYA PARTNERS INC,LATAM,2025-04-24,6,6,2,2,0
T&S,India,WIPRO LIMITED,APAC,2025-04-25,4,2,2,1,1
Technical Infrastructure,United States,GARDA WORLD SECURITY CORPORATION,NORTH AMERICA,2025-05-02,4,3,1,1,0
Technical Infrastructure,United States,"ROONEY HOLDINGS, INC.",NORTH AMERICA,2025-05-01,3,3,0,0,0
T&S,India,ACCENTURE PLC,APAC,2025-04-24,6,6,2,0,2
REWS,Romania,YARZIN SELLA MANAGEMENT AND HOLDINGS,EMEA,2025-04-24,3,3,0,0,0
Technical Infrastructure,India,INDIGO TELECOM GROUP LTD,APAC,2025-04-29,1,1,0,0,0
T&S,Malaysia,ACCENTURE PLC,APAC,2025-04-30,5,6,1,0,1
REWS,India,MEDIFIT CONSULTANTS PVT LTD,APAC,2025-05-02,3,3,0,0,0
Waymo,United States,TRANSDEV,NORTH AMERICA,2025-04-25,8,1,7,1,6
Technical Infrastructure,null,SCHENKER,NORTH AMERICA,2025-04-24,3,3,0,0,0
Technical Infrastructure,null,"HOLDER CONSTRUCTION GROUP, LLC",NORTH AMERICA,2025-04-29,3,5,0,0,0
Technical Infrastructure,United States,GARDA WORLD SECURITY CORPORATION,NORTH AMERICA,2025-04-28,4,3,1,1,0
Technical Infrastructure,United States,GARDA WORLD SECURITY CORPORATION,NORTH AMERICA,2025-04-22,3,1,2,1,1
T&S,Philippines,ACCENTURE PLC,APAC,2025-05-02,7,2,5,3,2
Technical Infrastructure,null,TW CONSTRUCTORS LLC,NORTH AMERICA,2025-04-22,3,5,0,0,0
Marketing,India,CYBAGE SOFTWARE PRIVATE LIMITED,APAC,2025-04-24,5,1,4,1,3
Technical Infrastructure,United States,GXO LOGISTICS WORLDWIDE LLC,NORTH AMERICA,2025-04-23,6,2,4,0,4
REWS,United States,BODY TECHNIQUES LLC,NORTH AMERICA,2025-04-23,11,3,8,4,4
T&S,India,WIPRO LIMITED,APAC,2025-04-28,4,1,3,0,3
Waymo,United States,METRO ONE LOSS PREVENTION SERVICES GROUP (GUARD DIVISION) INC,NORTH AMERICA,2025-04-23,3,3,2,1,1
Technical Infrastructure,India,ERICSSON INC,APAC,2025-04-29,3,5,0,0,0
Marketing,Thailand,ACCENTURE PLC,APAC,2025-04-23,11,6,7,6,1
Technical Infrastructure,null,J E DUNN CONSTRUCTION COMPANY,NORTH AMERICA,2025-05-02,3,3,0,0,0
YouTube,India,GENPACT LIMITED,APAC,2025-04-28,3,2,1,1,0
Access,United States,NETCRACKER TECHNOLOGY CORPORATION,NORTH AMERICA,2025-04-28,3,5,0,0,0
Marketing,United States,FIREWOOD MARKETING INC.,NORTH AMERICA,2025-04-22,3,1,2,1,1
Technical Infrastructure,United States,GARDA WORLD SECURITY CORPORATION,NORTH AMERICA,2025-05-02,4,3,1,1,0
gTech,Argentina,COGNIZANT TECHNOLOGY SOLUTIONS CORPORATION,LATAM,2025-04-23,10,1,9,2,7
gCS,Malaysia,TELEDIRECT PTE LTD,APAC,2025-04-21,2,1,1,1,0
REWS,India,SIMPLIWORK OFFICES PRIVATE LIMITED,APAC,2025-04-25,2,2,0,0,0
Cloud,United States,MEDIATEK INC,NORTH AMERICA,2025-04-28,17,11,10,10,0
Marketing,United States,ACCENTURE PLC,NORTH AMERICA,2025-05-01,3,2,1,0,1
Marketing,India,CYBAGE SOFTWARE PRIVATE LIMITED,APAC,2025-04-21,2,1,1,1,0
Waymo,India,WIPRO LIMITED,APAC,2025-04-24,3,3,1,0,1
Devices & Services,United States,MOSAIC US HOLDINGS INC,NORTH AMERICA,2025-04-25,4,1,3,0,3
gCS,India,TELEDIRECT PTE LTD,APAC,2025-04-22,6,4,2,1,1
Ads & Commerce,India,GLOBALLOGIC INC,APAC,2025-05-02,4,3,1,1,0
POps,United States,PREMISE HEALTH HOLDING CORP,NORTH AMERICA,2025-04-24,2,2,0,0,0
Cloud,Philippines,ACCENTURE PLC,APAC,2025-04-21,3,1,2,0,2
Geo,India,COGNIZANT TECHNOLOGY SOLUTIONS CORPORATION,APAC,2025-05-02,6,4,4,4,0
Technical Infrastructure,United States,GXO LOGISTICS WORLDWIDE LLC,NORTH AMERICA,2025-04-30,6,3,3,2,1
POps,India,ACCENTURE PLC,APAC,2025-05-02,7,2,5,0,5
Devices & Services,India,TECH MAHINDRA LIMITED,APAC,2025-04-27,10,3,7,0,7
Cloud,Mexico,TATA GROUP,LATAM,2025-04-22,8,1,7,6,1
Finance,India,GEP WORLDWIDE,APAC,2025-04-22,1,1,0,0,0
YouTube,India,GENPACT LIMITED,APAC,2025-04-28,3,2,1,0,1
REWS,United States,ACADEMY LOCKSMITH LP,NORTH AMERICA,2025-04-22,1,1,0,0,0
T&S,India,WIPRO LIMITED,APAC,2025-04-23,4,1,3,0,3
Technical Infrastructure,Finland,FIBER HIGHWAY FINLAND OY,EMEA,2025-04-24,2,1,1,0,1
Technical Infrastructure,United States,GXO LOGISTICS WORLDWIDE LLC,NORTH AMERICA,2025-04-21,7,4,5,4,1
gTech,India,TELEPERFORMANCE SE,APAC,2025-05-01,3,3,1,0,1
Access,United States,HR GREEN INC,NORTH AMERICA,2025-04-30,35,5,32,26,6
T&S,India,ACCENTURE PLC,APAC,2025-04-28,5,2,3,0,3
REWS,India,COMPASS GROUP PLC,APAC,2025-04-21,3,5,0,0,0
REWS,null,COMPASS GROUP PLC,APAC,2025-04-21,3,5,0,0,0
Technical Infrastructure,United States,J E DUNN CONSTRUCTION COMPANY,NORTH AMERICA,2025-05-02,3,3,0,0,0
Finance,India,PWC,APAC,2025-05-02,13,2,11,7,4
Platforms + Ecosystems,India,HCL TECHNOLOGIES LTD,APAC,2025-04-29,4,5,1,1,0
Technical Infrastructure,null,"ROONEY HOLDINGS, INC.",NORTH AMERICA,2025-04-29,3,5,0,0,0
REWS,India,JAGUAR SECURITY SERVICES PVT. LTD.,APAC,2025-04-23,1,1,0,0,0
Waymo,India,WIPRO LIMITED,APAC,2025-04-24,3,2,2,1,1
Technical Infrastructure,United States,"HOLDER CONSTRUCTION GROUP, LLC",NORTH AMERICA,2025-04-22,2,4,0,0,0
gTech,Brazil,CONCENTRIX,LATAM,2025-04-24,3,3,0,0,0
T&S,India,ACCENTURE PLC,APAC,2025-04-25,3,1,2,0,2
DeepMind,United States,SCALE AI INC,NORTH AMERICA,2025-04-21,18,1,17,0,17
Cloud,Mexico,TATA GROUP,LATAM,2025-04-25,18,2,16,1,15
REWS,null,YARZIN SELLA MANAGEMENT AND HOLDINGS,EMEA,2025-05-02,3,3,0,0,0
Technical Infrastructure,United States,SCHENKER,NORTH AMERICA,2025-04-25,2,2,0,0,0
REWS,India,SODEXO,APAC,2025-05-02,3,3,0,0,0
GBO (w/o gTech & gCS),Canada,MAGNIT GLOBAL CANADA LTD.,NORTH AMERICA,2025-04-28,3,13,0,0,0
gTech,India,VIRTUSA CORPORATION,APAC,2025-04-25,3,2,1,0,1
T&S,India,WIPRO LIMITED,APAC,2025-04-30,5,7,0,0,0
REWS,India,MEDIFIT CONSULTANTS PVT LTD,APAC,2025-04-25,2,2,0,0,0
Cloud,United States,MANTECH ADVANCED SYSTEMS INTERNATIONAL INC,NORTH AMERICA,2025-04-22,17,5,14,10,4
Waymo,United States,TRANSDEV,NORTH AMERICA,2025-04-24,7,3,4,4,0
Waymo,India,WIPRO LIMITED,APAC,2025-05-01,3,1,2,0,2
Cloud,India,COGNIZANT TECHNOLOGY SOLUTIONS CORPORATION,APAC,2025-04-24,2,2,0,0,0
REWS,United States,MC DEAN INC,NORTH AMERICA,2025-04-28,8,2,6,0,6
T&S,India,COGNIZANT TECHNOLOGY SOLUTIONS CORPORATION,APAC,2025-04-24,2,1,1,0,1
Technical Infrastructure,null,SATURN PARTNERS LLC,NORTH AMERICA,2025-04-24,3,3,0,0,0
YouTube,India,ACCENTURE PLC,APAC,2025-04-24,5,4,3,2,1
Waymo,India,WIPRO LIMITED,APAC,2025-04-22,6,7,1,1,0
YouTube,United States,TELEPERFORMANCE SE,NORTH AMERICA,2025-04-30,4,6,0,0,0
Geo,India,COGNIZANT TECHNOLOGY SOLUTIONS CORPORATION,APAC,2025-04-22,5,6,1,0,1
gTech,Brazil,HCL TECHNOLOGIES LTD,LATAM,2025-04-30,9,5,6,1,5
gTech,India,TELEPERFORMANCE SE,APAC,2025-04-25,4,2,2,1,1
T&S,Philippines,ACCENTURE PLC,APAC,2025-04-28,9,1,8,0,8
REWS,United Kingdom,COMPASS GROUP PLC,EMEA,2025-04-21,3,5,0,0,0
YouTube,Philippines,CONCENTRIX,APAC,2025-04-22,14,2,12,10,2
Technical Infrastructure,Taiwan,TATA GROUP,APAC,2025-04-30,3,5,0,0,0
Geo,India,COGNIZANT TECHNOLOGY SOLUTIONS CORPORATION,APAC,2025-04-21,2,1,1,1,0
T&S,India,COGNIZANT TECHNOLOGY SOLUTIONS CORPORATION,APAC,2025-04-25,7,2,5,1,4
Technical Infrastructure,United States,GXO LOGISTICS WORLDWIDE LLC,NORTH AMERICA,2025-04-25,6,6,2,2,0
REWS,India,JAGUAR SECURITY SERVICES PVT. LTD.,APAC,2025-04-23,1,1,0,0,0
Technical Infrastructure,Australia,MSS SECURITY PTY LTD,APAC,2025-04-22,5,2,3,0,3
Corp Eng,India,MOVATE TECHNOLOGIES PRIVATE LIMITED,APAC,2025-04-21,4,2,2,2,0
REWS,Switzerland,CBRE GROUP INC,EMEA,2025-04-25,2,2,0,0,0
Corp Eng,India,DELOITTE,APAC,2025-04-30,5,5,2,0,2
gTech,India,TECH MAHINDRA LIMITED,APAC,2025-04-21,3,2,1,0,1
Waymo,United States,TRANSDEV,NORTH AMERICA,2025-04-24,7,2,5,5,0
Waymo,China,SUPPLY CHAIN RESOURCES,APAC,2025-04-24,3,1,2,2,0
Platforms + Ecosystems,India,HCL TECHNOLOGIES LTD,APAC,2025-04-29,5,3,2,1,1
POps,India,RANDSTAD NV,APAC,2025-04-28,12,1,11,0,11
Technical Infrastructure,United States,GXO LOGISTICS WORLDWIDE LLC,NORTH AMERICA,2025-05-02,3,3,0,0,0
Ads & Commerce,United States,"APPLAUSE APP QUALITY, INC",NORTH AMERICA,2025-05-01,3,2,1,0,1
Global Affairs (w/o T&S),India,ACCENTURE PLC,APAC,2025-04-30,6,2,4,1,3
Cloud,Mexico,TATA GROUP,LATAM,2025-04-22,16,3,13,3,10
gTech,India,VIRTUSA CORPORATION,APAC,2025-04-25,3,3,0,0,0
Technical Infrastructure,United States,"HOLDER CONSTRUCTION GROUP, LLC",NORTH AMERICA,2025-04-22,1,1,0,0,0
YouTube,Malaysia,ACCENTURE PLC,APAC,2025-04-25,2,2,0,0,0
REWS,United States,ELECTROSONIC LIMITED,NORTH AMERICA,2025-04-22,3,5,0,0,0
T&S,India,WIPRO LIMITED,APAC,2025-04-30,5,2,3,0,3
YouTube,India,ACCENTURE PLC,APAC,2025-04-23,10,1,9,0,9
YouTube,India,WIPRO LIMITED,APAC,2025-04-29,1,1,0,0,0
YouTube,Portugal,TECH MAHINDRA LIMITED,EMEA,2025-04-24,7,3,4,2,2
REWS,null,CBRE GROUP INC,EMEA,2025-05-02,3,3,0,0,0
Geo,India,ACCENTURE PLC,APAC,2025-04-21,7,1,6,2,4
Devices & Services,India,TECH MAHINDRA LIMITED,APAC,2025-04-28,9,1,8,0,8
X,United States,TALENTFUL LIMITED,NORTH AMERICA,2025-04-28,3,2,0,0,0
Access,United States,HICKERSONS CABLE INSTALLATION INC,NORTH AMERICA,2025-04-21,5,3,2,2,0
Access,United States,INSIGHT,NORTH AMERICA,2025-04-23,5,2,3,0,3
Technical Infrastructure,United States,SCHENKER,NORTH AMERICA,2025-04-30,7,1,6,3,3
Cloud,India,INFOSYS,APAC,2025-04-23,4,6,0,0,0
gTech,India,TELEPERFORMANCE SE,APAC,2025-04-28,3,5,0,0,0
YouTube,India,CONCENTRIX,APAC,2025-04-30,3,4,1,0,1
REWS,null,COMPASS GROUP PLC,APAC,2025-04-28,3,5,0,0,0
gTech,Poland,TELEPERFORMANCE SE,EMEA,2025-04-28,3,5,0,0,0
gTech,Poland,TELEPERFORMANCE SE,EMEA,2025-04-29,4,6,0,0,0
T&S,India,WIPRO LIMITED,APAC,2025-04-28,4,1,3,1,2
REWS,United States,"INTER-CON SECURITY SYSTEMS, INC.",NORTH AMERICA,2025-04-29,3,5,0,0,0
gCS,Brazil,ATENTO S.A.,LATAM,2025-04-29,3,5,0,0,0
REWS,India,JONES LANG LASALLE INC,APAC,2025-04-23,2,2,0,0,0
REWS,United States,CBRE GROUP INC,NORTH AMERICA,2025-04-21,18,1,17,3,14
Corp Eng,India,MOVATE TECHNOLOGIES PRIVATE LIMITED,APAC,2025-04-21,4,1,3,0,3
Waymo,India,COGNIZANT TECHNOLOGY SOLUTIONS CORPORATION,APAC,2025-04-21,1,3,0,0,0
Technical Infrastructure,United States,SCHENKER,NORTH AMERICA,2025-04-29,5,1,4,0,4
Cloud,United States,MARKETSTAR CORPORATION,NORTH AMERICA,2025-04-28,3,2,1,0,1
Waymo,India,WIPRO LIMITED,APAC,2025-05-01,3,2,1,1,0
Marketing,United States,WHERE THE BUFFALO ROAM,NORTH AMERICA,2025-04-21,6,5,3,2,1
YouTube,Philippines,COGNIZANT TECHNOLOGY SOLUTIONS CORPORATION,APAC,2025-04-24,6,2,4,4,0
Waymo,United States,TRANSDEV,NORTH AMERICA,2025-05-01,7,2,5,2,3
gTech,India,GENPACT LIMITED,APAC,2025-04-24,2,2,0,0,0
Technical Infrastructure,United States,ROSENDIN ELECTRIC INC.,NORTH AMERICA,2025-04-21,2,4,0,0,0
gCS,India,REGALIX INC,APAC,2025-04-25,4,3,1,1,0
Technical Infrastructure,United States,GXO LOGISTICS WORLDWIDE LLC,NORTH AMERICA,2025-05-01,7,2,5,4,1
Cloud,India,HCL TECHNOLOGIES LTD,APAC,2025-04-21,3,5,0,0,0
T&S,India,WIPRO LIMITED,APAC,2025-04-23,4,4,2,0,2
REWS,null,CBRE GROUP INC,EMEA,2025-05-02,3,3,0,0,0
DeepMind,United States,SCALE AI INC,NORTH AMERICA,2025-04-23,18,4,16,16,0
T&S,Philippines,ACCENTURE PLC,APAC,2025-05-02,3,3,0,0,0
YouTube,India,ACCENTURE PLC,APAC,2025-04-24,6,5,3,0,3
Technical Infrastructure,United States,DIRECT LINE GLOBAL LLC,NORTH AMERICA,2025-04-24,4,6,0,0,0
gTech,India,COGNIZANT TECHNOLOGY SOLUTIONS CORPORATION,APAC,2025-04-23,3,4,1,1,0
Cloud,Philippines,ACCENTURE PLC,APAC,2025-04-28,3,2,1,1,0
REWS,United States,"INTER-CON SECURITY SYSTEMS, INC.",NORTH AMERICA,2025-04-28,3,5,0,0,0
Waymo,India,WIPRO LIMITED,APAC,2025-04-27,4,1,3,0,3
Cloud,El Salvador,TELUS,LATAM,2025-04-30,4,6,0,0,0
Cloud,Mexico,TATA GROUP,LATAM,2025-05-02,4,3,1,1,0
Waymo,United States,METRO ONE LOSS PREVENTION SERVICES GROUP (GUARD DIVISION) INC,NORTH AMERICA,2025-04-24,10,5,7,1,6
REWS,India,COMPASS GROUP PLC,APAC,2025-04-23,2,2,0,0,0
REWS,India,JONES LANG LASALLE INC,APAC,2025-04-23,1,1,0,0,0
Waymo,India,WIPRO LIMITED,APAC,2025-04-27,5,3,3,3,0
REWS,India,JONES LANG LASALLE INC,APAC,2025-04-22,1,1,0,0,0
Technical Infrastructure,null,THE WHITING TURNER CONTRACTING COMPANY,NORTH AMERICA,2025-04-22,3,5,0,0,0
Technical Infrastructure,United States,WHITEWAY BUILDING SERVICE INC,NORTH AMERICA,2025-04-29,3,5,0,0,0
Technical Infrastructure,United States,GXO LOGISTICS WORLDWIDE LLC,NORTH AMERICA,2025-04-22,5,2,3,2,1
REWS,India,SODEXO,APAC,2025-04-21,1,3,0,0,0
Technical Infrastructure,null,J E DUNN CONSTRUCTION COMPANY,NORTH AMERICA,2025-04-24,3,3,0,0,0
gCS,India,REGALIX INC,APAC,2025-04-25,4,3,1,1,0
Devices & Services,India,EPAM SYSTEMS INC,APAC,2025-04-23,6,3,3,3,0
gCS,India,TELEDIRECT PTE LTD,APAC,2025-04-23,2,2,0,0,0
REWS,United States,COMPASS GROUP PLC,NORTH AMERICA,2025-04-24,3,3,0,0,0
Technical Infrastructure,United States,DIRECT LINE GLOBAL LLC,NORTH AMERICA,2025-05-02,10,5,7,6,1
gCS,India,TELEDIRECT PTE LTD,APAC,2025-04-24,3,2,1,0,1
Access,United States,IBEX HOLDINGS LIMITED,NORTH AMERICA,2025-05-02,9,5,5,2,3
gTech,United States,"PRO UNLIMITED, INC. (VENDOR)",NORTH AMERICA,2025-04-21,3,1,2,0,2
REWS,United States,PFC GROUP OF COMPANIES,NORTH AMERICA,2025-04-29,4,5,1,0,1
YouTube,India,CONCENTRIX,APAC,2025-04-21,2,1,1,0,1
Technical Infrastructure,Thailand,JONES LANG LASALLE INC,APAC,2025-04-24,15,1,14,0,14
Cloud,Japan,SERVICESOURCE INTERNATIONAL INC,APAC,2025-04-23,2,1,1,1,0
Devices & Services,Taiwan,SGS S.A.,APAC,2025-04-27,9,1,8,7,1
YouTube,India,GENPACT LIMITED,APAC,2025-04-29,3,5,0,0,0
YouTube,India,CONCENTRIX,APAC,2025-04-22,5,1,4,0,4
gCS,Philippines,CONCENTRIX,APAC,2025-04-21,5,3,2,0,2
Waymo,United States,AMERIT FLEET SOLUTIONS INC.,NORTH AMERICA,2025-04-28,1,3,0,0,0
Corp Eng,India,IBM CORPORATION,APAC,2025-04-30,4,6,0,0,0
REWS,United Kingdom,FIRST,EMEA,2025-05-01,5,4,3,3,0
Technical Infrastructure,null,"ROONEY HOLDINGS, INC.",NORTH AMERICA,2025-04-29,3,5,0,0,0
Core (w/o Corp Eng),India,ACCENTURE PLC,APAC,2025-04-21,4,1,3,1,2
gTech,India,COGNIZANT TECHNOLOGY SOLUTIONS CORPORATION,APAC,2025-04-21,4,2,2,2,0
Corp Eng,India,VIRTUSA CORPORATION,APAC,2025-04-29,3,4,1,1,0
REWS,India,JONES LANG LASALLE INC,APAC,2025-04-22,1,1,0,0,0
Cloud,India,ACCENTURE PLC,APAC,2025-04-28,8,5,5,3,2
T&S,India,WIPRO LIMITED,APAC,2025-05-01,4,5,1,1,0
T&S,India,WIPRO LIMITED,APAC,2025-04-28,4,1,3,0,3
Technical Infrastructure,United States,SYNCREON GLOBAL HOLDINGS LIMITED,NORTH AMERICA,2025-04-22,3,4,1,0,1
T&S,null,TELEPERFORMANCE SE,LATAM,2025-04-28,3,5,0,0,0
YouTube,India,ACCENTURE PLC,APAC,2025-04-21,6,3,5,0,5
T&S,India,WIPRO LIMITED,APAC,2025-04-23,2,1,2,0,2
gTech,India,VIRTUSA CORPORATION,APAC,2025-04-25,3,2,1,0,1
gTech,Poland,TELEPERFORMANCE SE,EMEA,2025-04-28,3,5,0,0,0
Platforms + Ecosystems,India,MARKETSTAR CORPORATION,APAC,2025-05-02,4,1,3,3,0
gTech,Brazil,COGNIZANT TECHNOLOGY SOLUTIONS CORPORATION,LATAM,2025-04-22,4,2,2,0,2
T&S,Philippines,ACCENTURE PLC,APAC,2025-04-29,4,1,3,0,3
Cloud,United States,HCL TECHNOLOGIES LTD,NORTH AMERICA,2025-05-01,6,5,3,2,1
gTech,India,GENPACT LIMITED,APAC,2025-04-22,4,5,1,1,0
Devices & Services,Japan,FUJISOFT INCORPORATED,APAC,2025-04-22,15,3,12,1,11
Cloud,India,OPTIMUM INFOSYSTEMS PVT. LTD.,APAC,2025-05-02,5,8,2,0,2
Waymo,India,WIPRO LIMITED,APAC,2025-04-28,5,9,0,0,0
Ads & Commerce,India,WIPRO LIMITED,APAC,2025-04-24,2,2,0,0,0
POps,India,ACCENTURE PLC,APAC,2025-04-22,3,4,1,1,0
Access,United States,"GARY D. NELSON ASSOCIATES, INC.",NORTH AMERICA,2025-04-27,2,4,0,0,0
DeepMind,United Kingdom,ADECCO UK LIMITED,EMEA,2025-04-23,7,7,4,2,2
YouTube,India,ACCENTURE PLC,APAC,2025-04-24,5,1,4,0,4
Technical Infrastructure,null,J E DUNN CONSTRUCTION COMPANY,NORTH AMERICA,2025-05-02,3,3,0,0,0
Waymo,India,WIPRO LIMITED,APAC,2025-04-30,6,1,5,5,0
REWS,India,SODEXO,APAC,2025-05-02,3,3,0,0,0
gTech,Colombia,CONCENTRIX,LATAM,2025-04-22,1,1,0,0,0
POps,United States,PREMISE HEALTH HOLDING CORP,NORTH AMERICA,2025-04-21,2,4,0,0,0
REWS,United States,GARDA WORLD SECURITY CORPORATION,NORTH AMERICA,2025-04-28,3,1,2,0,2
Cloud,India,DELOITTE,APAC,2025-04-24,4,3,3,0,3
POps,India,KORN FERRY INTERNATIONAL,APAC,2025-04-24,3,1,2,1,1
YouTube,India,TATA GROUP,APAC,2025-04-24,4,5,1,0,1
Technical Infrastructure,United States,ALLIED UNIVERSAL,NORTH AMERICA,2025-04-23,2,2,0,0,0
gCS,India,TELEDIRECT PTE LTD,APAC,2025-04-28,5,3,2,1,1
Technical Infrastructure,United States,SCHENKER,NORTH AMERICA,2025-04-24,3,2,1,0,1
gTech,India,GENPACT LIMITED,APAC,2025-04-27,4,3,1,0,1
YouTube,Portugal,COGNIZANT TECHNOLOGY SOLUTIONS CORPORATION,EMEA,2025-04-30,6,3,3,0,3
YouTube,India,ACCENTURE PLC,APAC,2025-04-24,5,1,4,1,3
Finance,Philippines,ACCENTURE PLC,APAC,2025-04-30,5,2,3,3,0
gTech,India,TECH MAHINDRA LIMITED,APAC,2025-04-30,3,5,0,0,0
Technical Infrastructure,United States,GXO LOGISTICS WORLDWIDE LLC,NORTH AMERICA,2025-04-25,21,4,19,5,14
Technical Infrastructure,Netherlands,SYNCREON GLOBAL HOLDINGS LIMITED,EMEA,2025-04-24,15,4,13,3,10
DeepMind,Brazil,BUCK DESIGN LLC,LATAM,2025-04-25,12,5,9,0,9
Technical Infrastructure,United States,SCHENKER,NORTH AMERICA,2025-04-22,1,1,0,0,0
Ads & Commerce,Poland,HCL TECHNOLOGIES LTD,EMEA,2025-04-30,2,2,0,0,0
gTech,India,TELEPERFORMANCE SE,APAC,2025-04-25,4,3,1,0,1
Technical Infrastructure,United States,GXO LOGISTICS WORLDWIDE LLC,NORTH AMERICA,2025-04-28,4,2,2,1,1
REWS,India,SODEXO,APAC,2025-04-21,1,3,0,0,0
YouTube,United States,"ANSWERLAB, LLC",NORTH AMERICA,2025-05-02,4,3,1,1,0
Finance,India,ACCENTURE PLC,APAC,2025-05-02,6,5,3,1,2
Technical Infrastructure,United States,ALPHA SERVICES CORPORATION,NORTH AMERICA,2025-04-25,1,1,0,0,0
gTech,India,TELEPERFORMANCE SE,APAC,2025-04-27,5,3,2,2,0
REWS,United States,ELECTROSONIC LIMITED,NORTH AMERICA,2025-04-22,3,5,0,0,0
gTech,India,TELEPERFORMANCE SE,APAC,2025-04-22,5,1,4,1,3
Waymo,India,WIPRO LIMITED,APAC,2025-04-24,3,4,0,0,0
T&S,India,WIPRO LIMITED,APAC,2025-05-01,4,5,1,0,1
gTech,Philippines,ACCENTURE PLC,APAC,2025-04-28,2,4,0,0,0
Technical Infrastructure,United States,GXO LOGISTICS WORLDWIDE LLC,NORTH AMERICA,2025-04-25,3,3,0,0,0
gCS,India,REGALIX INC,APAC,2025-04-23,2,2,0,0,0
YouTube,India,CONCENTRIX,APAC,2025-04-21,3,2,1,1,0
YouTube,India,WIPRO LIMITED,APAC,2025-05-02,3,3,0,0,0
Technical Infrastructure,United States,ALLIED UNIVERSAL,NORTH AMERICA,2025-04-29,4,6,0,0,0
REWS,United States,ACCENTURE PLC,NORTH AMERICA,2025-04-25,6,6,2,2,0
Geo,India,ACCENTURE PLC,APAC,2025-04-25,16,1,15,1,14
POps,null,DELOITTE,APAC,2025-04-21,3,5,0,0,0
REWS,null,COMPASS GROUP PLC,APAC,2025-05-01,3,3,0,0,0
Technical Infrastructure,United States,GXO LOGISTICS WORLDWIDE LLC,NORTH AMERICA,2025-04-29,5,3,2,2,0
Technical Infrastructure,United States,SCHENKER,NORTH AMERICA,2025-04-22,5,1,4,4,0
Technical Infrastructure,Netherlands,RELLIUM LTD,EMEA,2025-04-23,1,1,0,0,0
Technical Infrastructure,United States,ALLIED UNIVERSAL,NORTH AMERICA,2025-04-25,3,2,1,1,0
gTech,India,TELEPERFORMANCE SE,APAC,2025-04-28,10,2,8,6,2
T&S,India,WIPRO LIMITED,APAC,2025-04-23,4,1,3,1,2
gCS,Brazil,TTEC HOLDINGS INC,LATAM,2025-04-23,5,1,4,4,0
Marketing,United States,MARVEL MARKETERS LLC,NORTH AMERICA,2025-04-30,5,2,3,1,2
gCS,India,TELEDIRECT PTE LTD,APAC,2025-04-29,6,7,1,0,1
Cloud,India,INFOSYS,APAC,2025-04-25,3,3,0,0,0
Geo,India,WIPRO LIMITED,APAC,2025-04-24,1,1,0,0,0
Technical Infrastructure,United States,LEDCOR IP HOLDINGS LTD,NORTH AMERICA,2025-04-29,3,5,0,0,0
REWS,United States,CBRE GROUP INC,NORTH AMERICA,2025-04-29,9,1,8,0,8
POps,China,ACCENTURE PLC,APAC,2025-04-21,11,5,8,3,5
Waymo,India,COGNIZANT TECHNOLOGY SOLUTIONS CORPORATION,APAC,2025-04-23,1,1,0,0,0
gTech,Colombia,CONCENTRIX,LATAM,2025-04-29,2,4,0,0,0
T&S,India,WIPRO LIMITED,APAC,2025-04-27,4,1,3,0,3
Cloud,Philippines,HCL TECHNOLOGIES LTD,APAC,2025-05-02,12,1,11,0,11
Ads & Commerce,Poland,TELUS,EMEA,2025-04-29,3,5,0,0,0
Technical Infrastructure,United States,"ROONEY HOLDINGS, INC.",NORTH AMERICA,2025-05-02,3,3,0,0,0
Technical Infrastructure,United States,"MOODY - HOLDER JV, A JOINT VENTURE",NORTH AMERICA,2025-04-23,1,1,0,0,0
REWS,India,JONES LANG LASALLE INC,APAC,2025-05-02,3,3,0,0,0
Cloud,India,INFOSYS,APAC,2025-04-29,2,3,1,0,1
YouTube,India,WIPRO LIMITED,APAC,2025-04-29,11,5,7,6,1
POps,India,ACCENTURE PLC,APAC,2025-04-21,6,5,3,1,2
Technical Infrastructure,United States,"PEERLESS CONSTRUCTION SOLUTIONS, LLC",NORTH AMERICA,2025-04-25,12,1,11,8,3
REWS,United States,ISS A/S,NORTH AMERICA,2025-04-23,1,1,0,0,0
T&S,India,COGNIZANT TECHNOLOGY SOLUTIONS CORPORATION,APAC,2025-04-28,5,1,4,0,4
gTech,Philippines,TELUS,APAC,2025-04-24,4,4,2,0,2
Waymo,India,WIPRO LIMITED,APAC,2025-04-30,2,2,0,0,0
T&S,Malaysia,ACCENTURE PLC,APAC,2025-04-24,11,2,9,6,3
gTech,India,HCL TECHNOLOGIES LTD,APAC,2025-04-27,4,2,2,0,2
Marketing,Japan,MCCANN,APAC,2025-04-24,11,2,9,1,8
Platforms + Ecosystems,United States,CIENET INTERNATIONAL LLC,NORTH AMERICA,2025-05-02,3,3,0,0,0
Marketing,United Kingdom,JELLYFISH GROUP LTD,EMEA,2025-04-23,11,3,8,7,1
Global Affairs (w/o T&S),Philippines,ACCENTURE PLC,APAC,2025-04-29,1,1,0,0,0
Technical Infrastructure,United States,GXO LOGISTICS WORLDWIDE LLC,NORTH AMERICA,2025-04-25,6,4,4,0,4
Waymo,India,COGNIZANT TECHNOLOGY SOLUTIONS CORPORATION,APAC,2025-04-23,1,1,0,0,0
gCS,India,ACCENTURE PLC,APAC,2025-04-22,9,2,7,0,7
Platforms + Ecosystems,United States,"PURPLE, ROCK, SCISSORS LLC",NORTH AMERICA,2025-04-30,6,3,3,2,1
Devices & Services,United States,MOSAIC US HOLDINGS INC,NORTH AMERICA,2025-04-28,4,3,1,0,1
gTech,United States,PWC,NORTH AMERICA,2025-04-23,9,1,8,1,7
REWS,India,G4S PLC,APAC,2025-04-24,1,1,0,0,0
POps,India,RANDSTAD NV,APAC,2025-04-24,6,1,5,0,5
T&S,India,WIPRO LIMITED,APAC,2025-04-28,5,1,4,4,0
REWS,null,JONES LANG LASALLE INC,APAC,2025-05-02,3,3,0,0,0
gTech,India,TELEPERFORMANCE SE,APAC,2025-04-23,7,7,2,2,0
Corp Eng,India,MOVATE TECHNOLOGIES PRIVATE LIMITED,APAC,2025-04-28,5,2,3,1,2
REWS,null,CBRE GROUP INC,NORTH AMERICA,2025-04-21,3,5,0,0,0
T&S,Philippines,ACCENTURE PLC,APAC,2025-04-29,10,3,7,0,7
REWS,United States,GRANT THORNTON INTERNATIONAL LTD,NORTH AMERICA,2025-04-22,1,1,0,0,0
YouTube,India,CONCENTRIX,APAC,2025-04-25,3,2,1,0,1
REWS,United States,JONES LANG LASALLE INC,NORTH AMERICA,2025-04-25,3,3,0,0,0
Cloud,Costa Rica,ACCENTURE PLC,LATAM,2025-04-25,2,2,0,0,0
gTech,India,TELEPERFORMANCE SE,APAC,2025-04-23,7,3,4,1,3
Ads & Commerce,India,"APPLAUSE APP QUALITY, INC",APAC,2025-04-30,6,2,4,4,0
Technical Infrastructure,United States,"HOLDER CONSTRUCTION GROUP, LLC",NORTH AMERICA,2025-04-21,4,6,0,0,0
REWS,India,JAGUAR SECURITY SERVICES PVT. LTD.,APAC,2025-04-22,3,1,2,0,2
Technical Infrastructure,United Kingdom,SYNERGY SECURITY SOLUTIONS LIMITED,EMEA,2025-04-24,5,4,3,0,3
REWS,null,ARAMARK HOLDINGS CORPORATION,NORTH AMERICA,2025-04-25,3,3,0,0,0
Waymo,United States,METRO ONE LOSS PREVENTION SERVICES GROUP (GUARD DIVISION) INC,NORTH AMERICA,2025-04-24,3,3,0,0,0
REWS,United States,JONES LANG LASALLE INC,NORTH AMERICA,2025-04-29,4,2,2,2,0
Corp Eng,India,MOVATE TECHNOLOGIES PRIVATE LIMITED,APAC,2025-04-25,4,2,2,0,2
gCS,India,REGALIX INC,APAC,2025-04-25,4,3,1,1,0
YouTube,India,CONCENTRIX,APAC,2025-04-30,2,3,0,0,0
gCS,India,ACCENTURE PLC,APAC,2025-04-30,6,3,3,3,0
Technical Infrastructure,Chile,SISTEMAS CONTRA INCENDIOS EUROCOMERCIAL LTDA,LATAM,2025-04-28,3,5,0,0,0
Geo,India,COGNIZANT TECHNOLOGY SOLUTIONS CORPORATION,APAC,2025-04-27,3,2,1,0,1
gTech,Mexico,QUALITEST,LATAM,2025-04-28,5,3,2,0,2
gCS,Argentina,TECHMOB SA,LATAM,2025-04-22,10,3,7,6,1
REWS,United States,"INTER-CON SECURITY SYSTEMS, INC.",NORTH AMERICA,2025-05-01,5,1,4,2,2
gCS,China,ACCENTURE PLC,APAC,2025-04-22,8,4,6,0,6
gCS,India,ACCENTURE PLC,APAC,2025-04-28,13,1,12,2,10
gTech,Brazil,CONCENTRIX,LATAM,2025-04-25,4,4,0,0,0
Geo,India,WIPRO LIMITED,APAC,2025-04-28,2,4,0,0,0
Waymo,India,COGNIZANT TECHNOLOGY SOLUTIONS CORPORATION,APAC,2025-04-21,1,3,0,0,0
Technical Infrastructure,United States,"HOLDER CONSTRUCTION GROUP, LLC",NORTH AMERICA,2025-04-30,2,2,0,0,0
Corp Eng,United States,SIGNIFI SOLUTIONS INC.,NORTH AMERICA,2025-04-22,3,5,0,0,0
Waymo,India,WIPRO LIMITED,APAC,2025-04-30,6,1,5,5,0
Technical Infrastructure,Netherlands,SCHENKER,EMEA,2025-05-02,3,3,0,0,0
YouTube,Malaysia,ACCENTURE PLC,APAC,2025-04-21,4,3,1,0,1
REWS,Canada,FLUXON APPS LLC,NORTH AMERICA,2025-05-01,11,2,9,7,2
gCS,India,WNS (HOLDINGS) LIMITED,APAC,2025-04-24,3,3,0,0,0
Waymo,United States,AMERIT FLEET SOLUTIONS INC.,NORTH AMERICA,2025-04-29,3,4,1,1,0
Technical Infrastructure,null,NIPPON TELEGRAPH AND TELEPHONE CORPORATION,APAC,2025-04-26,4,4,0,0,0
POps,null,DELOITTE,APAC,2025-04-21,3,5,0,0,0
T&S,India,ACCENTURE PLC,APAC,2025-04-21,6,3,5,0,5
Technical Infrastructure,United Kingdom,JCA ENGINEERING LTD,EMEA,2025-04-22,10,2,8,0,8
T&S,India,WIPRO LIMITED,APAC,2025-04-30,5,1,4,0,4
Global Affairs (w/o T&S),United States,USER RESEARCH INTERNATIONAL LLC,NORTH AMERICA,2025-04-23,5,5,2,1,1
REWS,United States,ANIXTER INC,NORTH AMERICA,2025-04-30,10,2,8,0,8
Technical Infrastructure,United States,"HOLDER CONSTRUCTION GROUP, LLC",NORTH AMERICA,2025-05-01,3,3,0,0,0
REWS,India,JONES LANG LASALLE INC,APAC,2025-04-25,3,3,0,0,0
YouTube,Malaysia,COGNIZANT TECHNOLOGY SOLUTIONS CORPORATION,APAC,2025-04-22,4,2,2,1,1
gCS,Canada,TELEPERFORMANCE SE,NORTH AMERICA,2025-04-21,5,null,5,4,1
Access,United States,"PROJECT RESOURCES GROUP, INC.",NORTH AMERICA,2025-05-02,9,3,6,0,6
Cloud,India,ACCENTURE PLC,APAC,2025-04-21,3,2,1,1,0
gTech,United States,VACO,NORTH AMERICA,2025-04-21,3,1,2,0,2
Technical Infrastructure,United States,GARDA WORLD SECURITY CORPORATION,NORTH AMERICA,2025-04-30,2,2,0,0,0
REWS,India,COMPASS GROUP PLC,APAC,2025-04-21,3,5,0,0,0
Platforms + Ecosystems,India,HCL TECHNOLOGIES LTD,APAC,2025-04-25,4,2,2,2,0
gTech,United States,VACO,NORTH AMERICA,2025-04-24,2,2,0,0,0
T&S,India,WIPRO LIMITED,APAC,2025-04-30,5,2,3,1,2
Geo,India,WIPRO LIMITED,APAC,2025-04-22,1,1,0,0,0
Technical Infrastructure,United States,ALLIED UNIVERSAL,NORTH AMERICA,2025-04-25,3,2,1,0,1
T&S,India,WIPRO LIMITED,APAC,2025-04-23,13,5,10,9,1
REWS,United States,"INTER-CON SECURITY SYSTEMS, INC.",NORTH AMERICA,2025-04-25,2,1,1,0,1
Technical Infrastructure,United States,ALLIED UNIVERSAL,NORTH AMERICA,2025-04-22,4,1,3,2,1
REWS,United States,COMPASS GROUP PLC,NORTH AMERICA,2025-04-22,1,1,0,0,0
Technical Infrastructure,null,MID COLUMBIA JANITORIAL INC,NORTH AMERICA,2025-04-24,3,3,0,0,0
Cloud,Japan,EPAM SYSTEMS INC,APAC,2025-04-30,4,6,0,0,0
Geo,India,WIPRO LIMITED,APAC,2025-04-28,2,4,0,0,0
Technical Infrastructure,United States,GXO LOGISTICS WORLDWIDE LLC,NORTH AMERICA,2025-04-29,5,3,2,1,1
T&S,India,COGNIZANT TECHNOLOGY SOLUTIONS CORPORATION,APAC,2025-04-23,4,1,3,1,2
T&S,Philippines,ACCENTURE PLC,APAC,2025-05-02,3,3,0,0,0
T&S,India,WIPRO LIMITED,APAC,2025-05-02,3,3,0,0,0
T&S,India,WIPRO LIMITED,APAC,2025-04-25,2,2,0,0,0
Technical Infrastructure,United States,SCHENKER,NORTH AMERICA,2025-04-24,2,2,0,0,0
T&S,India,WIPRO LIMITED,APAC,2025-05-01,6,7,1,0,1
gTech,India,COGNIZANT TECHNOLOGY SOLUTIONS CORPORATION,APAC,2025-04-25,3,2,1,0,1
Cloud,South Africa,SURESKILLS LIMITED,EMEA,2025-04-25,3,3,0,0,0
YouTube,India,COGNIZANT TECHNOLOGY SOLUTIONS CORPORATION,APAC,2025-05-02,3,3,0,0,0
REWS,null,JONES LANG LASALLE INC,APAC,2025-04-24,3,3,0,0,0
Technical Infrastructure,United States,"HOLDER CONSTRUCTION GROUP, LLC",NORTH AMERICA,2025-05-02,3,3,0,0,0
REWS,Japan,JONES LANG LASALLE INC,APAC,2025-04-22,1,1,0,0,0
Technical Infrastructure,United States,GARDA WORLD SECURITY CORPORATION,NORTH AMERICA,2025-04-22,1,1,1,0,1
Waymo,United States,SODEXO,NORTH AMERICA,2025-05-01,3,3,0,0,0
Global Affairs (w/o T&S),United States,AXIOM GLOBAL INC,NORTH AMERICA,2025-05-01,4,3,3,0,3
Devices & Services,India,ACCENTURE PLC,APAC,2025-04-30,5,2,3,2,1
Global Affairs (w/o T&S),India,KPMG,APAC,2025-04-22,2,4,0,0,0
Technical Infrastructure,Australia,MSS SECURITY PTY LTD,APAC,2025-04-22,5,1,4,0,4
YouTube,Philippines,TECH MAHINDRA LIMITED,APAC,2025-05-02,11,4,9,0,9
YouTube,India,CONCENTRIX,APAC,2025-04-24,2,2,0,0,0
Devices & Services,Taiwan,WIPRO LIMITED,APAC,2025-04-23,3,3,2,0,2
T&S,India,WIPRO LIMITED,APAC,2025-04-25,4,3,1,0,1
gTech,Portugal,TECH MAHINDRA LIMITED,EMEA,2025-04-21,5,2,3,1,2
gTech,Greece,TELEPERFORMANCE SE,EMEA,2025-04-22,9,5,6,0,6
REWS,Taiwan,JONES LANG LASALLE INC,APAC,2025-04-29,4,2,2,0,2
Waymo,United States,TRANSDEV,NORTH AMERICA,2025-04-25,8,1,7,3,4
Devices & Services,United States,MOSAIC US HOLDINGS INC,NORTH AMERICA,2025-04-28,10,3,7,1,6
Devices & Services,United States,"SYNOPSYS, INC",NORTH AMERICA,2025-05-01,4,4,2,1,1
Devices & Services,India,INFOSYS,APAC,2025-04-21,2,1,1,1,0
Geo,India,WIPRO LIMITED,APAC,2025-04-25,2,2,0,0,0
Technical Infrastructure,Japan,KAJIMA CORPORATION,APAC,2025-04-24,3,1,2,0,2
gTech,Portugal,TELEPERFORMANCE SE,EMEA,2025-04-21,6,3,5,0,5
Technical Infrastructure,Brazil,PROSEGUR SA,LATAM,2025-04-28,4,2,2,2,0
Waymo,United States,TRANSDEV,NORTH AMERICA,2025-04-24,7,2,5,2,3
YouTube,India,CONCENTRIX,APAC,2025-05-01,5,5,2,1,1
REWS,null,COMPASS GROUP PLC,APAC,2025-05-02,3,3,0,0,0
gTech,India,TELEPERFORMANCE SE,APAC,2025-04-28,3,5,0,0,0
Corp Eng,Singapore,NIPPON TELEGRAPH AND TELEPHONE CORPORATION,APAC,2025-04-29,4,2,2,0,2
REWS,United States,JONES LANG LASALLE INC,NORTH AMERICA,2025-05-02,15,7,10,0,10
REWS,United States,JONES LANG LASALLE INC,NORTH AMERICA,2025-04-25,3,3,0,0,0
T&S,Philippines,ACCENTURE PLC,APAC,2025-04-27,3,1,2,0,2
Cloud,Spain,TELEPERFORMANCE SE,EMEA,2025-04-28,3,5,0,0,0
T&S,India,WIPRO LIMITED,APAC,2025-04-25,2,2,0,0,0
T&S,Ireland,ACCENTURE PLC,EMEA,2025-04-22,6,2,4,1,3
Platforms + Ecosystems,India,ITTIAM SYSTEMS PVT LTD,APAC,2025-04-29,7,5,4,0,4
T&S,India,WIPRO LIMITED,APAC,2025-05-02,5,5,2,1,1
POps,India,RANDSTAD NV,APAC,2025-04-30,14,4,12,5,7
Technical Infrastructure,null,AIDAN STRAIN ELECTRICAL ENGINEERING LIMITED,EMEA,2025-04-28,2,4,0,0,0
Corp Eng,India,IBM CORPORATION,APAC,2025-04-25,3,1,2,0,2
gTech,Guatemala,TELUS,LATAM,2025-04-29,3,4,1,1,0
Waymo,United States,TRANSPORTATION RESEARCH CENTER INC.,NORTH AMERICA,2025-04-21,1,null,1,0,1
REWS,India,JONES LANG LASALLE INC,APAC,2025-04-25,3,3,0,0,0
gTech,India,TECH MAHINDRA LIMITED,APAC,2025-04-29,4,5,1,0,1
T&S,India,WIPRO LIMITED,APAC,2025-04-27,4,3,1,0,1
gTech,Poland,TELEPERFORMANCE SE,EMEA,2025-04-28,3,5,0,0,0
YouTube,India,COGNIZANT TECHNOLOGY SOLUTIONS CORPORATION,APAC,2025-04-22,3,5,0,0,0
gCS,India,ACCENTURE PLC,APAC,2025-04-27,9,1,8,0,8
Technical Infrastructure,United States,"HOLDER CONSTRUCTION GROUP, LLC",NORTH AMERICA,2025-04-30,2,2,0,0,0
gCS,India,TELEDIRECT PTE LTD,APAC,2025-04-22,11,3,8,0,8
Technical Infrastructure,United States,GXO LOGISTICS WORLDWIDE LLC,NORTH AMERICA,2025-04-28,9,6,5,4,1
Waymo,United States,LINKAGE DESIGN LLC,NORTH AMERICA,2025-04-22,4,1,3,0,3
Technical Infrastructure,Thailand,WOOD INTERNATIONAL LIMITED,APAC,2025-04-28,3,1,2,1,1
Technical Infrastructure,null,SCHENKER,NORTH AMERICA,2025-04-21,3,5,0,0,0
YouTube,India,ACCENTURE PLC,APAC,2025-04-21,6,4,4,0,4
Cloud,El Salvador,SERVICESOURCE INTERNATIONAL INC,LATAM,2025-04-28,3,5,0,0,0
Global Communications & Public Affairs,United States,ACCENTURE PLC,NORTH AMERICA,2025-04-24,5,4,3,0,3
gTech,India,COGNIZANT TECHNOLOGY SOLUTIONS CORPORATION,APAC,2025-04-30,5,2,3,1,2
Technical Infrastructure,null,"HOLDER CONSTRUCTION GROUP, LLC",NORTH AMERICA,2025-04-25,3,3,0,0,0
Cloud,Poland,TTEC HOLDINGS INC,EMEA,2025-04-28,6,6,2,2,0
Geo,India,COGNIZANT TECHNOLOGY SOLUTIONS CORPORATION,APAC,2025-04-25,2,2,0,0,0
Platforms + Ecosystems,India,ITTIAM SYSTEMS PVT LTD,APAC,2025-04-29,7,7,2,0,2
Ads & Commerce,India,TELEPERFORMANCE SE,APAC,2025-04-23,5,null,5,5,0
REWS,United Kingdom,COMPASS GROUP PLC,EMEA,2025-04-25,2,2,0,0,0
Geo,Philippines,HCL TECHNOLOGIES LTD,APAC,2025-04-27,4,1,3,0,3
Technical Infrastructure,United States,SCHENKER,NORTH AMERICA,2025-04-28,24,23,7,0,7
Cloud,Romania,COGNIZANT TECHNOLOGY SOLUTIONS CORPORATION,EMEA,2025-04-29,5,1,4,0,4
Technical Infrastructure,United States,TW CONSTRUCTORS LLC,NORTH AMERICA,2025-04-23,14,5,11,0,11
Technical Infrastructure,United States,GARDA WORLD SECURITY CORPORATION,NORTH AMERICA,2025-04-30,2,2,0,0,0
Technical Infrastructure,United States,"HOLDER CONSTRUCTION GROUP, LLC",NORTH AMERICA,2025-05-02,3,3,0,0,0
Technical Infrastructure,United States,"APEX INFRASTRUCTURE CONSULTANTS, LLC",NORTH AMERICA,2025-04-28,4,2,2,2,0
Technical Infrastructure,United States,GXO LOGISTICS WORLDWIDE LLC,NORTH AMERICA,2025-05-01,7,2,5,5,0
REWS,India,JONES LANG LASALLE INC,APAC,2025-04-23,2,2,0,0,0
REWS,India,JONES LANG LASALLE INC,APAC,2025-04-23,2,2,0,0,0
DeepMind,United States,SCALE AI INC,NORTH AMERICA,2025-04-21,16,3,15,1,14
Technical Infrastructure,United States,M A MORTENSON COMPANY,NORTH AMERICA,2025-04-28,1,3,0,0,0
gTech,India,TELEPERFORMANCE SE,APAC,2025-04-22,5,1,4,1,3
YouTube,India,GENPACT LIMITED,APAC,2025-04-28,3,2,1,0,1
Technical Infrastructure,null,SCHENKER,NORTH AMERICA,2025-04-21,3,5,0,0,0
Technical Infrastructure,United States,DIRECT LINE GLOBAL LLC,NORTH AMERICA,2025-04-23,3,4,1,1,0
REWS,null,SODEXO,LATAM,2025-04-28,3,5,0,0,0
Technical Infrastructure,United States,SCHENKER,NORTH AMERICA,2025-04-25,8,2,6,5,1
Technical Infrastructure,United States,GXO LOGISTICS WORLDWIDE LLC,NORTH AMERICA,2025-04-25,3,2,1,0,1
Waymo,India,WIPRO LIMITED,APAC,2025-04-28,3,1,2,0,2
YouTube,Malaysia,CONCENTRIX,APAC,2025-04-21,9,null,9,3,6
T&S,Portugal,ACCENTURE PLC,EMEA,2025-05-01,4,5,1,0,1
REWS,India,JONES LANG LASALLE INC,APAC,2025-04-23,2,2,0,0,0
Technical Infrastructure,United States,CBRE GROUP INC,NORTH AMERICA,2025-04-22,10,3,7,3,4
Finance,Poland,ACCENTURE PLC,EMEA,2025-05-02,7,6,3,2,1
POps,India,RANDSTAD NV,APAC,2025-04-25,11,5,8,3,5
gTech,India,COGNIZANT TECHNOLOGY SOLUTIONS CORPORATION,APAC,2025-04-23,3,3,2,1,1
gCS,Brazil,TTEC HOLDINGS INC,LATAM,2025-04-24,1,1,0,0,0
Finance,Brazil,DICON CONTABILIDADE LTDA,LATAM,2025-04-28,4,3,1,0,1
Waymo,India,COGNIZANT TECHNOLOGY SOLUTIONS CORPORATION,APAC,2025-04-30,2,2,0,0,0
Cloud,India,CREST DATA SYSTEMS,APAC,2025-04-27,3,2,1,0,1
REWS,India,JONES LANG LASALLE INC,APAC,2025-05-02,3,3,0,0,0
Access,United States,DYCOM INDUSTRIES,NORTH AMERICA,2025-04-22,3,5,0,0,0
Access,United States,"SYSTEM RESOURCES TELECOM, LLC (SRI)",NORTH AMERICA,2025-05-01,7,2,5,3,2
YouTube,India,GENPACT LIMITED,APAC,2025-04-28,3,2,1,0,1
gTech,United States,VACO,NORTH AMERICA,2025-04-22,4,5,1,0,1
gCS,Brazil,TTEC HOLDINGS INC,LATAM,2025-04-29,5,3,2,1,1
gCS,India,WNS (HOLDINGS) LIMITED,APAC,2025-04-24,3,1,2,2,0
Waymo,India,WIPRO LIMITED,APAC,2025-04-28,3,2,1,1,0
DeepMind,United Kingdom,HARVEY NASH PLC,EMEA,2025-05-01,10,46,7,4,3
Technical Infrastructure,United States,SCHENKER,NORTH AMERICA,2025-04-23,215,7,210,167,43
Core (w/o Corp Eng),United States,"PURPLE, ROCK, SCISSORS LLC",NORTH AMERICA,2025-04-22,6,4,2,0,2
YouTube,India,CONCENTRIX,APAC,2025-04-21,3,1,2,0,2
YouTube,United States,TATA GROUP,NORTH AMERICA,2025-04-28,8,2,6,0,6
YouTube,Romania,GENPACT LIMITED,EMEA,2025-04-23,9,4,7,7,0
REWS,United States,COMPASS GROUP PLC,NORTH AMERICA,2025-05-01,3,3,0,0,0
Global Affairs (w/o T&S),India,ACCENTURE PLC,APAC,2025-04-23,5,2,3,1,2
gTech,Portugal,TECH MAHINDRA LIMITED,EMEA,2025-04-28,3,2,1,1,0
Geo,Poland,COGNIZANT TECHNOLOGY SOLUTIONS CORPORATION,EMEA,2025-04-22,4,2,2,0,2
T&S,Portugal,COGNIZANT TECHNOLOGY SOLUTIONS CORPORATION,EMEA,2025-04-22,6,1,5,4,1
Devices & Services,United States,WIPRO LIMITED,NORTH AMERICA,2025-05-02,8,3,5,3,2
Geo,Israel,NISHA PRO SOFTWARE CONSULTANTS LTD,EMEA,2025-04-22,11,2,9,8,1
Devices & Services,United States,QUEST GLOBAL SERVICES PTE. LTD.,NORTH AMERICA,2025-04-29,3,5,0,0,0
Waymo,India,COGNIZANT TECHNOLOGY SOLUTIONS CORPORATION,APAC,2025-05-02,4,3,1,1,0
gTech,Poland,TELEPERFORMANCE SE,EMEA,2025-04-21,3,5,0,0,0
REWS,United States,PROPARK AMERICA WEST LLC,NORTH AMERICA,2025-04-30,4,6,0,0,0
REWS,India,COMPASS GROUP PLC,APAC,2025-05-01,3,3,0,0,0
Platforms + Ecosystems,United States,SCALENCE LLC,NORTH AMERICA,2025-04-25,3,2,1,0,1
Cloud,Philippines,ACCENTURE PLC,APAC,2025-04-22,8,4,6,5,1
Technical Infrastructure,Finland,FIBER HIGHWAY FINLAND OY,EMEA,2025-04-28,2,4,0,0,0
gTech,United States,VACO,NORTH AMERICA,2025-04-29,4,2,2,0,2
gTech,Poland,TELEPERFORMANCE SE,EMEA,2025-04-28,3,5,0,0,0
Cloud,Spain,CONCENTRIX,EMEA,2025-04-30,2,2,0,0,0
Cloud,India,DELOITTE,APAC,2025-04-25,2,2,0,0,0
T&S,India,ACCENTURE PLC,APAC,2025-04-27,4,3,1,0,1
Cloud,India,CAPGEMINI SE,APAC,2025-04-23,1,1,0,0,0
gTech,United Kingdom,MORGAN MCKINLEY LTD,EMEA,2025-05-01,12,20,8,7,1
Global Affairs (w/o T&S),United States,LEGALENG CONSULTING GROUP INC,NORTH AMERICA,2025-04-21,30,3,27,1,26
Cloud,India,EPAM SYSTEMS INC,APAC,2025-05-02,3,3,0,0,0
gTech,India,ACCENTURE PLC,APAC,2025-04-25,6,5,3,2,1
T&S,Philippines,ACCENTURE PLC,APAC,2025-05-01,4,5,1,0,1
YouTube,Malaysia,CONCENTRIX,APAC,2025-04-23,10,1,9,0,9
REWS,India,JONES LANG LASALLE INC,APAC,2025-04-22,1,1,0,0,0
REWS,India,JAGUAR SECURITY SERVICES PVT. LTD.,APAC,2025-04-28,4,3,1,1,0
Access,United States,DYCOM INDUSTRIES,NORTH AMERICA,2025-04-21,10,2,8,4,4
Technical Infrastructure,null,"HOLDER CONSTRUCTION GROUP, LLC",NORTH AMERICA,2025-04-28,3,5,0,0,0
T&S,India,WIPRO LIMITED,APAC,2025-04-23,5,5,2,0,2
POps,India,ACCENTURE PLC,APAC,2025-04-23,9,1,8,8,0
gTech,India,VIRTUSA CORPORATION,APAC,2025-04-25,3,2,1,0,1
REWS,India,JAGUAR SECURITY SERVICES PVT. LTD.,APAC,2025-04-29,5,7,0,0,0
gCS,India,ACCENTURE PLC,APAC,2025-04-24,13,2,11,7,4
Cloud,India,TECH MAHINDRA LIMITED,APAC,2025-04-21,2,1,1,1,0
Technical Infrastructure,United States,SCHENKER,NORTH AMERICA,2025-04-23,2,1,1,1,0
Platforms + Ecosystems,Philippines,ACCENTURE PLC,APAC,2025-05-02,4,3,1,0,1
YouTube,Philippines,TECH MAHINDRA LIMITED,APAC,2025-04-23,8,3,7,0,7
Cloud,Bulgaria,TELUS,EMEA,2025-05-02,5,5,2,2,0
REWS,United States,ELECTROSONIC LIMITED,NORTH AMERICA,2025-04-28,3,5,0,0,0
Waymo,India,COGNIZANT TECHNOLOGY SOLUTIONS CORPORATION,APAC,2025-04-24,2,1,1,0,1
REWS,India,JONES LANG LASALLE INC,APAC,2025-05-02,3,3,0,0,0
Ads & Commerce,Poland,TELUS,EMEA,2025-05-02,6,5,3,2,1
Cloud,Philippines,ACCENTURE PLC,APAC,2025-04-29,6,2,4,4,0
gTech,Colombia,CONCENTRIX,LATAM,2025-04-30,3,4,1,0,1
Technical Infrastructure,United States,"ROONEY HOLDINGS, INC.",NORTH AMERICA,2025-04-28,2,4,0,0,0
REWS,France,CBRE GROUP INC,EMEA,2025-04-23,5,2,3,0,3
gTech,India,VIRTUSA CORPORATION,APAC,2025-04-25,3,2,1,0,1
Waymo,Philippines,"TASKUS, INC.",APAC,2025-04-24,7,3,4,4,0
Corp Eng,Romania,CONCENTRIX,EMEA,2025-04-28,3,5,0,0,0
T&S,India,ACCENTURE PLC,APAC,2025-04-22,15,1,14,0,14
Cloud,Spain,TELEPERFORMANCE SE,EMEA,2025-04-22,7,4,5,2,3
Global Affairs (w/o T&S),India,ACCENTURE PLC,APAC,2025-04-30,5,2,3,3,0
Technical Infrastructure,India,MOTIVITY LABS INC,APAC,2025-04-21,4,1,3,1,2
YouTube,India,CONCENTRIX,APAC,2025-04-30,4,4,2,1,1
Technical Infrastructure,India,ACCENTURE PLC,APAC,2025-04-30,3,4,1,0,1
Cloud,United States,MANTECH ADVANCED SYSTEMS INTERNATIONAL INC,NORTH AMERICA,2025-04-22,17,5,14,0,14
T&S,Portugal,ACCENTURE PLC,EMEA,2025-04-30,11,1,10,2,8
Geo,India,ACCENTURE PLC,APAC,2025-04-21,12,1,11,1,10
Technical Infrastructure,null,EVERGREEN JANITORIAL SERVICES INC,NORTH AMERICA,2025-04-25,3,3,0,0,0
Platforms + Ecosystems,India,ITTIAM SYSTEMS PVT LTD,APAC,2025-04-28,6,5,3,0,3
T&S,Philippines,ACCENTURE PLC,APAC,2025-04-22,6,2,4,3,1
Technical Infrastructure,null,"HOLDER CONSTRUCTION GROUP, LLC",NORTH AMERICA,2025-05-02,3,3,0,0,0
Technical Infrastructure,United States,SCHENKER,NORTH AMERICA,2025-05-02,3,3,0,0,0
Access,United States,"BRUNGARDT HONOMICHL & COMPANY, P.A",NORTH AMERICA,2025-04-23,2,2,0,0,0
REWS,null,SODEXO,APAC,2025-04-28,3,5,0,0,0
Global Affairs (w/o T&S),United States,"CONSILIO, INC",NORTH AMERICA,2025-04-25,6,4,4,0,4
Technical Infrastructure,Netherlands,SCHENKER,EMEA,2025-04-29,9,6,5,1,4
REWS,India,SODEXO,APAC,2025-04-22,1,1,0,0,0
Technical Infrastructure,United States,GXO LOGISTICS WORLDWIDE LLC,NORTH AMERICA,2025-04-24,2,2,0,0,0
Technical Infrastructure,United States,GXO LOGISTICS WORLDWIDE LLC,NORTH AMERICA,2025-04-25,12,5,9,5,4
POps,India,ACCENTURE PLC,APAC,2025-04-22,6,2,4,1,3
Technical Infrastructure,null,NIPPON TELEGRAPH AND TELEPHONE CORPORATION,APAC,2025-04-25,3,3,0,0,0
YouTube,India,CONCENTRIX,APAC,2025-04-21,3,2,1,0,1
gTech,India,TELEPERFORMANCE SE,APAC,2025-04-22,5,1,4,1,3
YouTube,India,CONCENTRIX,APAC,2025-04-21,4,2,2,2,0
gCS,Brazil,ATENTO S.A.,LATAM,2025-04-29,3,5,0,0,0
Waymo,United States,TRANSDEV,NORTH AMERICA,2025-04-25,8,3,5,1,4
gTech,India,TELEPERFORMANCE SE,APAC,2025-04-28,5,3,2,1,1
YouTube,India,CONCENTRIX,APAC,2025-04-29,2,4,0,0,0
Waymo,United States,AMERIT FLEET SOLUTIONS INC.,NORTH AMERICA,2025-04-28,1,3,0,0,0
Cloud,United States,TRILYON INC,NORTH AMERICA,2025-04-29,2,4,0,0,0
Cloud,India,ACCENTURE PLC,APAC,2025-04-21,3,1,2,0,2
T&S,India,WIPRO LIMITED,APAC,2025-04-28,4,1,3,3,0
Global Affairs (w/o T&S),United States,AXIOM GLOBAL INC,NORTH AMERICA,2025-04-21,3,5,0,0,0
gTech,India,COGNIZANT TECHNOLOGY SOLUTIONS CORPORATION,APAC,2025-04-30,4,5,1,1,0
POps,India,RANDSTAD NV,APAC,2025-04-28,9,1,8,0,8
YouTube,India,ACCENTURE PLC,APAC,2025-04-21,6,4,4,0,4
Waymo,India,COGNIZANT TECHNOLOGY SOLUTIONS CORPORATION,APAC,2025-04-21,1,3,0,0,0
Cloud,United States,MEDIATEK INC,NORTH AMERICA,2025-04-29,6,3,3,0,3
T&S,Philippines,ACCENTURE PLC,APAC,2025-04-28,9,3,6,0,6
YouTube,India,ACCENTURE PLC,APAC,2025-04-21,6,3,5,1,4
REWS,India,JONES LANG LASALLE INC,APAC,2025-04-23,1,1,0,0,0
Access,Poland,EPAM SYSTEMS INC,EMEA,2025-04-30,5,5,2,2,0
Finance,United States,KPMG,NORTH AMERICA,2025-04-23,6,2,4,0,4
Geo,India,WIPRO LIMITED,APAC,2025-04-24,1,2,0,0,0
Technical Infrastructure,null,SCHENKER,NORTH AMERICA,2025-04-21,3,5,0,0,0
Finance,United States,MCKINSEY & COMPANY,NORTH AMERICA,2025-04-27,6,4,4,0,4
Access,Canada,LYNX PLANNING & ENGINEERING INC,NORTH AMERICA,2025-04-28,5,2,3,1,2
T&S,Spain,COGNIZANT TECHNOLOGY SOLUTIONS CORPORATION,EMEA,2025-04-25,7,1,6,0,6
Technical Infrastructure,Netherlands,SYNCREON GLOBAL HOLDINGS LIMITED,EMEA,2025-04-30,6,2,4,3,1
Access,United States,INFOGAIN CORPORATION,NORTH AMERICA,2025-05-02,3,3,0,0,0
Cloud,El Salvador,SERVICESOURCE INTERNATIONAL INC,LATAM,2025-04-28,3,5,0,0,0
T&S,India,WIPRO LIMITED,APAC,2025-04-25,4,1,3,1,2
Technical Infrastructure,United States,MCFARLAND BUILDING GROUP LLC,NORTH AMERICA,2025-04-29,1,1,0,0,0
gCS,India,REGALIX INC,APAC,2025-04-21,2,4,0,0,0
Cloud,Malaysia,TELEDIRECT PTE LTD,APAC,2025-04-21,3,5,0,0,0
REWS,India,COMPASS GROUP PLC,APAC,2025-04-25,2,2,0,0,0
Access,United States,DYCOM INDUSTRIES,NORTH AMERICA,2025-04-28,3,2,1,1,0
Marketing,Colombia,HUGE LLC,LATAM,2025-04-22,12,6,8,8,0
Technical Infrastructure,United States,GXO LOGISTICS WORLDWIDE LLC,NORTH AMERICA,2025-04-29,5,2,3,1,2
Technical Infrastructure,United States,VISION TECHNOLOGIES INC.,NORTH AMERICA,2025-04-21,4,3,1,0,1
YouTube,India,COGNIZANT TECHNOLOGY SOLUTIONS CORPORATION,APAC,2025-04-25,3,2,1,0,1
Technical Infrastructure,United States,ALLIED UNIVERSAL,NORTH AMERICA,2025-04-23,2,1,1,0,1
Technical Infrastructure,United States,THE WHITING TURNER CONTRACTING COMPANY,NORTH AMERICA,2025-04-22,3,5,0,0,0
Devices & Services,India,HCL TECHNOLOGIES LTD,APAC,2025-04-23,3,5,0,0,0
gCS,India,REGALIX INC,APAC,2025-04-25,4,3,1,1,0
Marketing,United States,LUCKY DAY LLC,NORTH AMERICA,2025-05-01,7,3,4,1,3
Technical Infrastructure,null,C D MOODY CONSTRUCTION COMPANY INC,NORTH AMERICA,2025-04-24,3,3,0,0,0
Search,null,TECH MAHINDRA LIMITED,APAC,2025-04-30,3,5,0,0,0
Technical Infrastructure,United States,SCHENKER,NORTH AMERICA,2025-04-22,4,2,2,2,0
Platforms + Ecosystems,United States,WIPRO LIMITED,NORTH AMERICA,2025-05-01,3,4,0,0,0
REWS,Finland,CBRE GROUP INC,EMEA,2025-05-02,3,3,0,0,0
T&S,India,WIPRO LIMITED,APAC,2025-04-23,4,4,2,0,2
Global Affairs (w/o T&S),India,ACCENTURE PLC,APAC,2025-04-21,5,2,3,1,2
Geo,India,ACCENTURE PLC,APAC,2025-04-21,7,1,6,2,4
REWS,India,SODEXO,APAC,2025-04-22,1,1,0,0,0
Technical Infrastructure,United States,"ROONEY HOLDINGS, INC.",NORTH AMERICA,2025-04-22,3,5,0,0,0
REWS,United Kingdom,CBRE GROUP INC,EMEA,2025-04-24,2,2,0,0,0
T&S,India,WIPRO LIMITED,APAC,2025-04-25,4,2,2,0,2
Cloud,Philippines,ACCENTURE PLC,APAC,2025-04-22,8,1,7,1,6
Corp Eng,India,HCL TECHNOLOGIES LTD,APAC,2025-04-21,6,3,5,0,5
Cloud,Costa Rica,ACCENTURE PLC,LATAM,2025-04-28,3,2,1,0,1
HUE,United States,SCALENCE LLC,NORTH AMERICA,2025-04-23,5,1,4,1,3
Technical Infrastructure,Chile,CRUZ Y DAVILA INGENIEROS CONSULTORES LTDA,LATAM,2025-04-21,8,12,0,0,0
Technical Infrastructure,Ireland,GAGAMULLER LIMITED,EMEA,2025-04-22,8,1,7,2,5
Waymo,India,WIPRO LIMITED,APAC,2025-04-24,3,2,2,2,0
Cloud,Mexico,SCALENCE LLC,LATAM,2025-04-22,1,1,0,0,0
gTech,India,TELEPERFORMANCE SE,APAC,2025-04-22,4,1,3,1,2
Devices & Services,India,TECH MAHINDRA LIMITED,APAC,2025-04-27,9,1,8,0,8
T&S,India,ACCENTURE PLC,APAC,2025-04-22,3,4,1,0,1
Finance,India,PWC,APAC,2025-04-25,13,1,12,0,12
gTech,United States,VACO,NORTH AMERICA,2025-05-02,7,5,4,2,2
gTech,India,COGNIZANT TECHNOLOGY SOLUTIONS CORPORATION,APAC,2025-05-02,3,3,0,0,0
T&S,India,COGNIZANT TECHNOLOGY SOLUTIONS CORPORATION,APAC,2025-04-21,1,3,0,0,0
YouTube,India,CONCENTRIX,APAC,2025-04-21,3,2,1,1,0
GBO (w/o gTech & gCS),Singapore,ACCENTURE PLC,APAC,2025-04-27,3,1,2,0,2
REWS,null,JONES LANG LASALLE INC,APAC,2025-05-02,3,3,0,0,0
T&S,Portugal,ACCENTURE PLC,EMEA,2025-04-28,3,2,1,0,1
gTech,India,VIRTUSA CORPORATION,APAC,2025-04-25,3,3,0,0,0
REWS,United States,COMPASS GROUP PLC,NORTH AMERICA,2025-04-29,6,3,3,2,1
REWS,India,JAGUAR SECURITY SERVICES PVT. LTD.,APAC,2025-04-23,1,1,0,0,0
Access,United States,DYCOM INDUSTRIES,NORTH AMERICA,2025-04-24,3,4,0,0,0
REWS,India,JAGUAR SECURITY SERVICES PVT. LTD.,APAC,2025-04-28,4,3,1,1,0
REWS,United States,JONES LANG LASALLE INC,NORTH AMERICA,2025-05-02,7,5,4,2,2
Cloud,United States,BRILLIANT MUSE LLC,NORTH AMERICA,2025-04-28,5,3,2,2,0
POps,South Korea,DELOITTE,APAC,2025-04-29,3,5,0,0,0
REWS,India,SODEXO,APAC,2025-04-24,3,3,0,0,0
gTech,India,TELEPERFORMANCE SE,APAC,2025-04-28,3,5,0,0,0
Geo,India,WIPRO LIMITED,APAC,2025-04-23,2,1,1,0,1
gTech,India,TELEPERFORMANCE SE,APAC,2025-04-21,5,3,4,2,2
Technical Infrastructure,null,NIPPON TELEGRAPH AND TELEPHONE CORPORATION,APAC,2025-04-21,3,5,0,0,0
Technical Infrastructure,United States,GARDA WORLD SECURITY CORPORATION,NORTH AMERICA,2025-04-21,14,1,13,2,11
Waymo,India,WIPRO LIMITED,APAC,2025-04-27,4,1,3,0,3
gTech,India,TELEPERFORMANCE SE,APAC,2025-04-30,2,2,1,0,1
REWS,Australia,CHALLENGER SECURITY PTY LTD,APAC,2025-05-01,7,6,3,2,1
Technical Infrastructure,United States,SCHENKER,NORTH AMERICA,2025-04-29,6,2,4,3,1
REWS,India,JONES LANG LASALLE INC,APAC,2025-05-02,3,3,0,0,0
Technical Infrastructure,United States,SCHENKER,NORTH AMERICA,2025-04-30,7,1,6,2,4
Technical Infrastructure,Denmark,QVISTGAARD IS,EMEA,2025-05-01,3,4,0,0,0
gTech,India,GENPACT LIMITED,APAC,2025-04-29,4,6,0,0,0
Technical Infrastructure,United States,TW CONSTRUCTORS LLC,NORTH AMERICA,2025-04-23,1,1,0,0,0
Waymo,United States,TRANSDEV,NORTH AMERICA,2025-04-29,3,4,1,1,0
Access,Brazil,GLOBANT LLC,LATAM,2025-04-29,2,4,0,0,0
Cloud,United States,"MAGNIT, LLC",NORTH AMERICA,2025-05-01,7,11,3,3,0
T&S,Spain,COGNIZANT TECHNOLOGY SOLUTIONS CORPORATION,EMEA,2025-04-25,7,2,5,1,4
Technical Infrastructure,United States,SCHENKER,NORTH AMERICA,2025-04-29,6,3,3,2,1
REWS,India,COMPASS GROUP PLC,APAC,2025-04-21,2,4,0,0,0
gTech,Philippines,ALORICA INC,APAC,2025-04-24,11,5,8,1,7
Technical Infrastructure,United States,"CBM OF AMERICA, INC. (VENDOR)",NORTH AMERICA,2025-04-24,6,8,0,0,0
Cloud,United States,HCL TECHNOLOGIES LTD,NORTH AMERICA,2025-04-28,4,6,0,0,0
Global Affairs (w/o T&S),India,ACCENTURE PLC,APAC,2025-04-23,2,1,1,1,0
T&S,India,CONCENTRIX,APAC,2025-04-21,3,2,1,0,1
Platforms + Ecosystems,United States,CIENET INTERNATIONAL LLC,NORTH AMERICA,2025-05-02,3,3,0,0,0
T&S,India,COGNIZANT TECHNOLOGY SOLUTIONS CORPORATION,APAC,2025-04-28,5,2,3,0,3
gCS,India,TELEDIRECT PTE LTD,APAC,2025-04-23,2,2,0,0,0
gCS,India,ACCENTURE PLC,APAC,2025-04-25,14,1,13,6,7
Waymo,India,WIPRO LIMITED,APAC,2025-05-01,3,3,0,0,0
DeepMind,United Kingdom,JAGUAR BUILDING SERVICES LIMITED,EMEA,2025-05-02,3,3,0,0,0
Technical Infrastructure,null,EXYTE GMBH,EMEA,2025-05-02,3,3,0,0,0
YouTube,India,WIPRO LIMITED,APAC,2025-04-24,8,3,6,0,6
Technical Infrastructure,United States,SCHENKER,NORTH AMERICA,2025-04-28,4,3,1,0,1
YouTube,Philippines,TECH MAHINDRA LIMITED,APAC,2025-04-21,6,3,5,3,2
gTech,India,COGNIZANT TECHNOLOGY SOLUTIONS CORPORATION,APAC,2025-04-23,2,1,1,0,1
YouTube,India,ACCENTURE PLC,APAC,2025-04-21,6,3,5,0,5
YouTube,India,ACCENTURE PLC,APAC,2025-04-21,6,4,4,0,4
T&S,India,WIPRO LIMITED,APAC,2025-04-25,2,5,0,0,0
gCS,Spain,TELEPERFORMANCE SE,EMEA,2025-04-29,5,3,2,2,0
Devices & Services,India,TECH MAHINDRA LIMITED,APAC,2025-04-28,9,1,8,8,0
gTech,India,COGNIZANT TECHNOLOGY SOLUTIONS CORPORATION,APAC,2025-04-23,2,2,0,0,0
Technical Infrastructure,United States,COMPLETE CLEANING SERVICES LLC.,NORTH AMERICA,2025-04-29,3,5,0,0,0
T&S,Costa Rica,TELEPERFORMANCE SE,LATAM,2025-05-02,7,5,4,0,4
gTech,India,VIRTUSA CORPORATION,APAC,2025-04-25,3,3,0,0,0
Waymo,United States,TRANSDEV,NORTH AMERICA,2025-04-25,8,2,6,0,6
Technical Infrastructure,United States,TW CONSTRUCTORS LLC,NORTH AMERICA,2025-04-25,2,2,0,0,0
Devices & Services,United States,BAYONE SOLUTIONS INC.,NORTH AMERICA,2025-04-28,3,5,0,0,0
Devices & Services,null,QUEST GLOBAL SERVICES PTE. LTD.,APAC,2025-04-21,3,5,0,0,0
Technical Infrastructure,null,SCHENKER,NORTH AMERICA,2025-04-28,3,5,0,0,0
REWS,null,SWINERTON BUILDERS INC,NORTH AMERICA,2025-04-29,3,5,0,0,0
T&S,India,CONCENTRIX,APAC,2025-04-25,3,1,2,2,0
gTech,Philippines,TELUS,APAC,2025-04-28,6,3,5,5,0
Technical Infrastructure,United States,ALLIED UNIVERSAL,NORTH AMERICA,2025-04-24,3,2,1,0,1
T&S,India,WIPRO LIMITED,APAC,2025-04-30,5,7,0,0,0
Waymo,India,WIPRO LIMITED,APAC,2025-04-24,3,4,0,0,0
Ads & Commerce,India,COGNIZANT TECHNOLOGY SOLUTIONS CORPORATION,APAC,2025-04-29,4,2,2,1,1
gCS,India,REGALIX INC,APAC,2025-04-23,2,2,0,0,0
YouTube,Greece,TELEPERFORMANCE SE,EMEA,2025-04-30,2,2,0,0,0
Waymo,India,WIPRO LIMITED,APAC,2025-04-24,3,2,2,1,1
T&S,India,WIPRO LIMITED,APAC,2025-04-28,5,3,2,0,2
REWS,Singapore,COMPASS GROUP PLC,APAC,2025-04-22,3,5,0,0,0
T&S,India,WIPRO LIMITED,APAC,2025-04-30,3,5,0,0,0
GBO (w/o gTech & gCS),Germany,NASH DIRECT GMBH,EMEA,2025-04-22,7,38,2,1,1
Search,India,INFOSYS,APAC,2025-04-21,1,null,1,0,1
gCS,India,REGALIX INC,APAC,2025-04-25,4,3,1,1,0
REWS,United States,JAMESTOWN L.P.,NORTH AMERICA,2025-04-25,11,4,9,0,9
Finance,United States,"RYAN, LLC.",NORTH AMERICA,2025-05-01,18,1,17,1,16
REWS,null,JOHNSON CONTROLS INTERNATIONAL PLC,EMEA,2025-04-21,3,5,0,0,0
T&S,India,WIPRO LIMITED,APAC,2025-04-28,5,1,4,3,1
Cloud,Philippines,HCL TECHNOLOGIES LTD,APAC,2025-04-30,10,2,8,0,8
Search,India,GLOBALLOGIC INC,APAC,2025-05-02,3,3,0,0,0
gTech,India,COGNIZANT TECHNOLOGY SOLUTIONS CORPORATION,APAC,2025-04-27,3,1,2,1,1
Technical Infrastructure,United States,GXO LOGISTICS WORLDWIDE LLC,NORTH AMERICA,2025-04-28,2,4,0,0,0
Technical Infrastructure,United States,DIRECT LINE GLOBAL LLC,NORTH AMERICA,2025-04-24,4,5,1,0,1
YouTube,India,CONCENTRIX,APAC,2025-04-21,4,3,1,0,1
YouTube,Philippines,TECH MAHINDRA LIMITED,APAC,2025-05-02,11,1,10,1,9
Cloud,Mexico,TATA GROUP,LATAM,2025-04-21,7,1,6,6,0
gTech,United States,VACO,NORTH AMERICA,2025-04-29,4,6,0,0,0
Technical Infrastructure,United States,SCHENKER,NORTH AMERICA,2025-04-29,2,3,1,0,1
Global Affairs (w/o T&S),United States,"CONSILIO, INC",NORTH AMERICA,2025-04-30,9,4,7,0,7
T&S,India,WIPRO LIMITED,APAC,2025-05-02,4,3,1,0,1
Cloud,United States,NETAPP INC,NORTH AMERICA,2025-05-02,17,7,12,2,10
Technical Infrastructure,Ireland,GERTEK PROJECT MANAGEMENT AND TECHNICAL SERVICES LIMITED,EMEA,2025-05-02,14,3,11,3,8
Devices & Services,India,WIPRO LIMITED,APAC,2025-04-21,6,4,4,0,4
YouTube,Ireland,ACCENTURE PLC,EMEA,2025-04-22,4,2,2,2,0
T&S,India,COGNIZANT TECHNOLOGY SOLUTIONS CORPORATION,APAC,2025-04-21,4,2,2,0,2
Platforms + Ecosystems,India,ITTIAM SYSTEMS PVT LTD,APAC,2025-04-28,6,5,3,0,3
Technical Infrastructure,Chile,GXO LOGISTICS WORLDWIDE LLC,LATAM,2025-04-30,6,6,2,0,2
gTech,Philippines,ALORICA INC,APAC,2025-04-23,2,2,0,0,0
REWS,Israel,YARZIN SELLA MANAGEMENT AND HOLDINGS,EMEA,2025-05-02,3,3,0,0,0
gCS,India,TELEDIRECT PTE LTD,APAC,2025-04-28,5,7,0,0,0
Technical Infrastructure,Netherlands,SYNCREON GLOBAL HOLDINGS LIMITED,EMEA,2025-04-23,15,2,13,1,12
Cloud,Brazil,ACCENTURE PLC,LATAM,2025-04-25,8,2,6,5,1
YouTube,India,WIPRO LIMITED,APAC,2025-05-01,13,10,6,5,1
gTech,India,TELEPERFORMANCE SE,APAC,2025-04-25,9,3,6,5,1
Technical Infrastructure,United States,SCHENKER,NORTH AMERICA,2025-04-22,11,3,8,4,4
T&S,India,WIPRO LIMITED,APAC,2025-04-21,6,4,4,2,2
T&S,India,WIPRO LIMITED,APAC,2025-04-25,4,3,1,0,1
Geo,India,ACCENTURE PLC,APAC,2025-04-24,3,1,2,2,0
YouTube,India,ACCENTURE PLC,APAC,2025-04-21,6,3,5,1,4
REWS,United States,COMPASS GROUP PLC,NORTH AMERICA,2025-04-23,2,2,0,0,0
YouTube,United States,TELEPERFORMANCE SE,NORTH AMERICA,2025-04-30,5,1,4,2,2
Technical Infrastructure,United States,GXO LOGISTICS WORLDWIDE LLC,NORTH AMERICA,2025-04-24,5,1,4,0,4
REWS,India,JONES LANG LASALLE INC,APAC,2025-04-24,2,2,0,0,0
REWS,United States,SUREFOX CONSULTING LLC,NORTH AMERICA,2025-04-24,2,2,0,0,0
Technical Infrastructure,United States,LEDCOR IP HOLDINGS LTD,NORTH AMERICA,2025-04-29,3,5,0,0,0
gCS,Malaysia,TELEDIRECT PTE LTD,APAC,2025-04-23,4,6,0,0,0
X,India,INFOCUSP INNOVATIONS LLP,APAC,2025-04-30,2,2,1,0,1
GBO (w/o gTech & gCS),Canada,MAGNIT GLOBAL CANADA LTD.,NORTH AMERICA,2025-04-25,6,7,3,0,3
Technical Infrastructure,null,J E DUNN CONSTRUCTION COMPANY,NORTH AMERICA,2025-04-24,3,3,0,0,0
gTech,Poland,MAJOREL GLOBAL,EMEA,2025-04-23,5,6,1,0,1
T&S,India,WIPRO LIMITED,APAC,2025-04-30,3,3,2,1,1
Platforms + Ecosystems,India,MARKETSTAR CORPORATION,APAC,2025-04-28,2,4,0,0,0
gTech,India,VACO,APAC,2025-04-25,9,3,6,5,1
Technical Infrastructure,United States,GARDA WORLD SECURITY CORPORATION,NORTH AMERICA,2025-04-30,2,2,0,0,0
gTech,India,VIRTUSA CORPORATION,APAC,2025-04-28,4,2,2,2,0
Technical Infrastructure,United States,"HOLDER CONSTRUCTION GROUP, LLC",NORTH AMERICA,2025-04-22,10,14,0,0,0
Geo,India,COGNIZANT TECHNOLOGY SOLUTIONS CORPORATION,APAC,2025-04-28,3,5,0,0,0
Cloud,Mexico,EPAM SYSTEMS INC,LATAM,2025-04-23,2,2,0,0,0
Waymo,India,COGNIZANT TECHNOLOGY SOLUTIONS CORPORATION,APAC,2025-04-29,9,1,8,0,8
Waymo,United States,METRO ONE LOSS PREVENTION SERVICES GROUP (GUARD DIVISION) INC,NORTH AMERICA,2025-04-30,7,3,4,2,2
YouTube,Greece,TELEPERFORMANCE SE,EMEA,2025-05-02,4,3,1,1,0
YouTube,India,CONCENTRIX,APAC,2025-04-21,4,3,1,1,0
REWS,United States,SODEXO,NORTH AMERICA,2025-04-25,2,2,0,0,0
Devices & Services,United States,MOSAIC US HOLDINGS INC,NORTH AMERICA,2025-04-28,5,2,3,2,1
gTech,India,TELEPERFORMANCE SE,APAC,2025-04-22,5,2,3,1,2
gCS,Philippines,CONCENTRIX,APAC,2025-04-30,2,2,0,0,0
POps,null,WIPRO LIMITED,EMEA,2025-05-02,3,3,0,0,0
Technical Infrastructure,United States,THE WHITING TURNER CONTRACTING COMPANY,NORTH AMERICA,2025-04-29,5,3,2,0,2
Geo,India,ACCENTURE PLC,APAC,2025-04-21,9,1,8,2,6
Waymo,India,WIPRO LIMITED,APAC,2025-04-24,3,2,2,0,2
Geo,India,ACCENTURE PLC,APAC,2025-05-02,6,4,4,0,4
T&S,India,WIPRO LIMITED,APAC,2025-04-23,3,3,2,0,2
REWS,null,COMPASS GROUP PLC,NORTH AMERICA,2025-05-01,3,3,0,0,0
REWS,null,PROPARK AMERICA WEST LLC,NORTH AMERICA,2025-04-29,3,5,0,0,0
Technical Infrastructure,United States,GXO LOGISTICS WORLDWIDE LLC,NORTH AMERICA,2025-04-21,2,4,0,0,0
Technical Infrastructure,Australia,MSS SECURITY PTY LTD,APAC,2025-04-22,5,2,3,0,3
Cloud,United States,MEDIATEK INC,NORTH AMERICA,2025-04-23,14,5,11,11,0
T&S,Poland,ACCENTURE PLC,EMEA,2025-04-23,9,5,6,0,6
Cloud,India,INFOSYS,APAC,2025-04-21,2,4,0,0,0
gTech,Brazil,CONCENTRIX,LATAM,2025-04-24,3,3,0,0,0
gCS,United States,"MINDLANCE, INC.",NORTH AMERICA,2025-04-30,9,15,6,3,3
REWS,United States,JONES LANG LASALLE INC,NORTH AMERICA,2025-04-29,2,4,0,0,0
REWS,India,CONVERGINT TECHNOLOGIES GROUP L.P.,APAC,2025-05-01,3,3,0,0,0
Geo,India,ACCENTURE PLC,APAC,2025-04-21,9,1,8,3,5
T&S,Philippines,ACCENTURE PLC,APAC,2025-04-21,5,2,3,0,3
Technical Infrastructure,United States,DIRECT LINE GLOBAL LLC,NORTH AMERICA,2025-04-28,1,3,0,0,0
Technical Infrastructure,United States,GARDA WORLD SECURITY CORPORATION,NORTH AMERICA,2025-04-24,3,2,1,0,1
Technical Infrastructure,Chile,CRUZ Y DAVILA INGENIEROS CONSULTORES LTDA,LATAM,2025-04-21,8,12,0,0,0
Waymo,Philippines,"TASKUS, INC.",APAC,2025-04-25,18,2,16,1,15
T&S,India,COGNIZANT TECHNOLOGY SOLUTIONS CORPORATION,APAC,2025-04-21,6,3,5,0,5
Cloud,India,COGNIZANT TECHNOLOGY SOLUTIONS CORPORATION,APAC,2025-04-22,2,3,1,1,0
REWS,United States,"INTER-CON SECURITY SYSTEMS, INC.",NORTH AMERICA,2025-05-02,6,5,3,3,0
Technical Infrastructure,null,SISTEMAS CONTRA INCENDIOS EUROCOMERCIAL LTDA,LATAM,2025-04-28,3,5,0,0,0
Ads & Commerce,Philippines,ACCENTURE PLC,APAC,2025-04-27,15,2,13,0,13
Technical Infrastructure,United States,ALLIED UNIVERSAL,NORTH AMERICA,2025-04-25,3,2,1,0,1
YouTube,Portugal,TELEPERFORMANCE SE,EMEA,2025-04-29,8,4,6,2,4
REWS,null,SODEXO,APAC,2025-05-02,3,3,0,0,0
Technical Infrastructure,United States,SCHENKER,NORTH AMERICA,2025-04-30,2,2,0,0,0
GBO (w/o gTech & gCS),Japan,ROBERT WALTERS JAPAN K.K.,APAC,2025-04-24,5,6,1,0,1
Technical Infrastructure,Netherlands,SYNCREON GLOBAL HOLDINGS LIMITED,EMEA,2025-04-28,4,3,1,0,1
gTech,India,TELEPERFORMANCE SE,APAC,2025-04-29,6,3,3,3,0
Waymo,India,WIPRO LIMITED,APAC,2025-04-30,7,9,1,1,0
Technical Infrastructure,United States,ALLIED UNIVERSAL,NORTH AMERICA,2025-04-24,3,2,1,0,1
Geo,Brazil,EPAM SYSTEMS INC,LATAM,2025-04-25,8,1,7,0,7
T&S,India,WIPRO LIMITED,APAC,2025-04-30,5,2,3,1,2
POps,India,RANDSTAD NV,APAC,2025-04-25,8,1,7,7,0
Access,United States,IBEX HOLDINGS LIMITED,NORTH AMERICA,2025-04-22,3,4,1,0,1
YouTube,India,ACCENTURE PLC,APAC,2025-04-23,5,5,2,1,1
Technical Infrastructure,United States,GXO LOGISTICS WORLDWIDE LLC,NORTH AMERICA,2025-04-22,3,4,1,0,1
POps,India,RANDSTAD NV,APAC,2025-05-02,7,2,5,0,5
Devices & Services,India,TECH MAHINDRA LIMITED,APAC,2025-05-02,4,3,1,0,1
Technical Infrastructure,United States,DIRECT LINE GLOBAL LLC,NORTH AMERICA,2025-04-29,4,5,1,0,1
YouTube,Romania,GENPACT LIMITED,EMEA,2025-04-28,4,3,1,1,0
REWS,United States,JONES LANG LASALLE INC,NORTH AMERICA,2025-04-25,5,4,3,3,0
gCS,India,REGALIX INC,APAC,2025-04-25,4,3,1,1,0
REWS,Australia,JONES LANG LASALLE INC,APAC,2025-05-02,3,3,0,0,0
Waymo,India,WIPRO LIMITED,APAC,2025-04-30,6,2,4,2,2
Technical Infrastructure,United States,SCHENKER,NORTH AMERICA,2025-04-24,3,2,1,1,0
gTech,India,VIRTUSA CORPORATION,APAC,2025-04-24,2,2,0,0,0
Cloud,India,CAPGEMINI SE,APAC,2025-04-21,3,2,1,1,0
Platforms + Ecosystems,United States,MAGIC LEAP INC.,NORTH AMERICA,2025-04-23,5,2,3,0,3
REWS,null,COMPASS GROUP PLC,EMEA,2025-04-30,3,5,0,0,0
Technical Infrastructure,United States,GARDA WORLD SECURITY CORPORATION,NORTH AMERICA,2025-04-24,1,1,0,0,0
Access,United States,IBEX HOLDINGS LIMITED,NORTH AMERICA,2025-04-22,2,3,1,0,1
gTech,Poland,TELEPERFORMANCE SE,EMEA,2025-04-28,3,5,0,0,0
DeepMind,United States,BUCK DESIGN LLC,NORTH AMERICA,2025-04-29,14,5,11,10,1
T&S,India,WIPRO LIMITED,APAC,2025-04-28,4,1,3,0,3
T&S,India,WIPRO LIMITED,APAC,2025-05-02,7,2,5,0,5
Access,United States,ITC SERVICE GROUP ACQUISITION LLC,NORTH AMERICA,2025-04-22,6,4,2,1,1
GBO (w/o gTech & gCS),Philippines,ACCENTURE PLC,APAC,2025-04-29,2,4,0,0,0
YouTube,India,ACCENTURE PLC,APAC,2025-05-02,6,4,4,0,4
Technical Infrastructure,India,HCL TECHNOLOGIES LTD,APAC,2025-04-28,4,6,0,0,0
REWS,United States,GARDA WORLD SECURITY CORPORATION,NORTH AMERICA,2025-04-24,2,2,0,0,0
T&S,Thailand,COGNIZANT TECHNOLOGY SOLUTIONS CORPORATION,APAC,2025-04-22,1,1,0,0,0
gTech,India,VIRTUSA CORPORATION,APAC,2025-04-24,2,2,0,0,0
Geo,India,TECH MAHINDRA LIMITED,APAC,2025-05-02,3,3,0,0,0
Technical Infrastructure,United States,ADECCO GROUP AG,NORTH AMERICA,2025-04-25,7,7,4,0,4
Technical Infrastructure,null,MID COLUMBIA JANITORIAL INC,NORTH AMERICA,2025-04-22,3,5,0,0,0
gTech,India,COGNIZANT TECHNOLOGY SOLUTIONS CORPORATION,APAC,2025-04-21,9,2,7,6,1
Technical Infrastructure,United States,SCHENKER,NORTH AMERICA,2025-05-01,5,4,3,0,3
Technical Infrastructure,United States,GXO LOGISTICS WORLDWIDE LLC,NORTH AMERICA,2025-05-02,3,3,0,0,0
REWS,null,STANTEC INC.,NORTH AMERICA,2025-04-29,3,5,0,0,0
REWS,Singapore,JONES LANG LASALLE INC,APAC,2025-04-27,3,1,2,0,2
Access,United States,DYCOM INDUSTRIES,NORTH AMERICA,2025-05-02,9,4,5,4,1
T&S,Philippines,ACCENTURE PLC,APAC,2025-05-02,3,3,0,0,0
Technical Infrastructure,United States,SCHENKER,NORTH AMERICA,2025-04-24,2,2,0,0,0
gTech,India,TELEPERFORMANCE SE,APAC,2025-04-24,3,2,1,0,1
Technical Infrastructure,United States,GARDA WORLD SECURITY CORPORATION,NORTH AMERICA,2025-04-30,2,1,1,1,0
Geo,India,ACCENTURE PLC,APAC,2025-04-21,12,1,11,0,11
REWS,Spain,CBRE GROUP INC,EMEA,2025-05-01,3,3,0,0,0
Waymo,United States,"TASKUS, INC.",NORTH AMERICA,2025-04-21,4,3,1,0,1
POps,India,ACCENTURE PLC,APAC,2025-04-21,5,2,3,1,2
REWS,India,JONES LANG LASALLE INC,APAC,2025-04-23,2,2,0,0,0
Corp Eng,United States,ACCENTURE PLC,NORTH AMERICA,2025-04-27,5,1,4,0,4
T&S,Malaysia,ACCENTURE PLC,APAC,2025-04-28,3,2,1,0,1
gCS,India,COGNIZANT TECHNOLOGY SOLUTIONS CORPORATION,APAC,2025-05-02,4,3,1,1,0
Waymo,United States,TRANSDEV,NORTH AMERICA,2025-04-22,2,3,1,1,0
gTech,Philippines,ACCENTURE PLC,APAC,2025-04-30,4,5,1,1,0
Waymo,United States,TRANSDEV,NORTH AMERICA,2025-04-25,6,7,1,0,1
Technical Infrastructure,United States,GXO LOGISTICS WORLDWIDE LLC,NORTH AMERICA,2025-04-22,10,3,7,4,3
gTech,India,COGNIZANT TECHNOLOGY SOLUTIONS CORPORATION,APAC,2025-04-27,3,2,1,1,0
gTech,India,COGNIZANT TECHNOLOGY SOLUTIONS CORPORATION,APAC,2025-05-02,7,5,4,3,1
Waymo,United States,TRANSDEV,NORTH AMERICA,2025-04-28,8,1,7,1,6
Technical Infrastructure,United States,SCHENKER,NORTH AMERICA,2025-04-23,9,5,6,6,0
gTech,China,COGNIZANT TECHNOLOGY SOLUTIONS CORPORATION,APAC,2025-04-23,3,3,2,2,0
T&S,United States,TELEPERFORMANCE SE,NORTH AMERICA,2025-04-24,3,2,1,0,1
gTech,India,TELEPERFORMANCE SE,APAC,2025-04-21,9,3,6,6,0
REWS,India,COMPASS GROUP PLC,APAC,2025-04-25,2,2,0,0,0
POps,India,RANDSTAD NV,APAC,2025-04-28,12,4,10,5,5
gTech,Greece,TELEPERFORMANCE SE,EMEA,2025-04-30,2,2,0,0,0
T&S,India,WIPRO LIMITED,APAC,2025-04-22,10,3,7,7,0
REWS,Brazil,JONES LANG LASALLE INC,LATAM,2025-04-30,5,6,1,1,0
gCS,Spain,TELEPERFORMANCE SE,EMEA,2025-04-23,6,2,4,3,1
gCS,India,TELEDIRECT PTE LTD,APAC,2025-04-28,5,4,1,0,1
REWS,Australia,CHALLENGER SECURITY PTY LTD,APAC,2025-04-21,7,6,3,3,0
gTech,India,GENPACT LIMITED,APAC,2025-04-23,3,4,1,1,0
Technical Infrastructure,United States,MCFARLAND BUILDING GROUP LLC,NORTH AMERICA,2025-04-29,1,1,0,0,0
Waymo,India,COGNIZANT TECHNOLOGY SOLUTIONS CORPORATION,APAC,2025-04-21,1,3,0,0,0
YouTube,India,ACCENTURE PLC,APAC,2025-05-02,6,4,4,0,4
REWS,France,CBRE GROUP INC,EMEA,2025-04-22,5,7,0,0,0
REWS,India,SODEXO,APAC,2025-04-22,1,1,0,0,0
Technical Infrastructure,Australia,MSS SECURITY PTY LTD,APAC,2025-04-22,5,1,4,0,4
Access,United States,IBEX HOLDINGS LIMITED,NORTH AMERICA,2025-04-22,3,1,2,0,2
Cloud,Philippines,ACCENTURE PLC,APAC,2025-04-28,8,5,5,2,3
gTech,India,COGNIZANT TECHNOLOGY SOLUTIONS CORPORATION,APAC,2025-04-23,5,2,3,3,0
Core (w/o Corp Eng),United States,BRILLIANT MUSE LLC,NORTH AMERICA,2025-04-22,3,4,1,1,0
Marketing,France,ADECCO FRANCE S.A.S.,EMEA,2025-04-24,26,6,23,15,8
REWS,Switzerland,CBRE GROUP INC,EMEA,2025-04-25,9,1,8,0,8
Technical Infrastructure,United States,"EPC PROJECT MANAGEMENT CONSULTING, LLC",NORTH AMERICA,2025-04-29,4,5,1,0,1
YouTube,Malaysia,ACCENTURE PLC,APAC,2025-04-21,4,3,1,1,0
YouTube,India,GENPACT LIMITED,APAC,2025-04-28,3,2,1,0,1
gTech,Poland,MAJOREL GLOBAL,EMEA,2025-04-23,5,5,2,2,0
Waymo,India,COGNIZANT TECHNOLOGY SOLUTIONS CORPORATION,APAC,2025-04-23,1,1,0,0,0
Platforms + Ecosystems,India,MARKETSTAR CORPORATION,APAC,2025-04-24,1,1,0,0,0
Platforms + Ecosystems,India,HCL TECHNOLOGIES LTD,APAC,2025-04-25,3,1,2,0,2
Technical Infrastructure,United States,GXO LOGISTICS WORLDWIDE LLC,NORTH AMERICA,2025-05-02,3,3,0,0,0
Access,United States,"PROJECT RESOURCES GROUP, INC.",NORTH AMERICA,2025-04-24,3,3,0,0,0
Technical Infrastructure,null,EVERGREEN JANITORIAL SERVICES INC,NORTH AMERICA,2025-04-22,3,5,0,0,0
DeepMind,United States,SCALE AI INC,NORTH AMERICA,2025-04-21,16,5,13,0,13
REWS,Belgium,CBRE GROUP INC,EMEA,2025-04-29,20,14,10,7,3
gTech,Philippines,CONCENTRIX,APAC,2025-04-25,4,2,2,0,2
Technical Infrastructure,United States,GXO LOGISTICS WORLDWIDE LLC,NORTH AMERICA,2025-04-25,6,4,4,0,4
gTech,India,CONCENTRIX,APAC,2025-05-02,7,5,4,3,1
Cloud,Philippines,ACCENTURE PLC,APAC,2025-04-27,3,1,2,2,0
Global Affairs (w/o T&S),India,ACCENTURE PLC,APAC,2025-04-29,5,2,3,1,2
Technical Infrastructure,United States,GXO LOGISTICS WORLDWIDE LLC,NORTH AMERICA,2025-05-02,16,4,14,4,10
gTech,India,VIRTUSA CORPORATION,APAC,2025-04-25,3,2,1,0,1
GBO (w/o gTech & gCS),United Kingdom,MORGAN MCKINLEY LTD,EMEA,2025-05-02,13,17,9,0,9
POps,India,RANDSTAD NV,APAC,2025-05-02,7,1,6,3,3
Ads & Commerce,Philippines,ACCENTURE PLC,APAC,2025-04-22,8,1,7,7,0
YouTube,India,CONCENTRIX,APAC,2025-04-21,2,1,1,0,1
Cloud,India,EPAM SYSTEMS INC,APAC,2025-04-30,2,3,1,1,0
gTech,Brazil,CONCENTRIX,LATAM,2025-04-25,4,3,1,1,0
Corp Eng,United States,ONE DIVERSIFIED LLC,NORTH AMERICA,2025-04-30,5,1,4,0,4
Waymo,United States,MAGIC MIGHT INC,NORTH AMERICA,2025-04-22,10,3,7,0,7
gCS,India,ACCENTURE PLC,APAC,2025-04-21,11,3,10,2,8
Platforms + Ecosystems,United States,MAGIC LEAP INC.,NORTH AMERICA,2025-05-01,10,4,8,0,8
YouTube,India,GENPACT LIMITED,APAC,2025-04-28,3,2,1,1,0
T&S,United States,ACCENTURE PLC,NORTH AMERICA,2025-04-29,5,2,3,1,2
Cloud,India,HCL TECHNOLOGIES LTD,APAC,2025-05-02,3,3,0,0,0
REWS,India,COMPASS GROUP PLC,APAC,2025-04-21,3,5,0,0,0
T&S,India,COGNIZANT TECHNOLOGY SOLUTIONS CORPORATION,APAC,2025-04-21,4,1,3,1,2
REWS,Singapore,SECURITY AND RISK SOLUTIONS PTE LTD,APAC,2025-04-27,5,1,4,4,0
YouTube,India,ACCENTURE PLC,APAC,2025-04-28,7,4,5,1,4
Waymo,United States,TRANSDEV,NORTH AMERICA,2025-05-01,7,3,4,0,4
Technical Infrastructure,India,INDIGO TELECOM GROUP LTD,APAC,2025-04-30,2,2,0,0,0
REWS,United States,ARAMARK HOLDINGS CORPORATION,NORTH AMERICA,2025-04-25,3,3,0,0,0
REWS,India,JONES LANG LASALLE INC,APAC,2025-04-24,2,2,0,0,0
REWS,Canada,JONES LANG LASALLE INC,NORTH AMERICA,2025-04-25,2,2,0,0,0
Waymo,India,WIPRO LIMITED,APAC,2025-04-27,4,1,3,0,3
Ads & Commerce,India,VIRTUSA CORPORATION,APAC,2025-04-24,11,2,9,9,0
POps,India,ACCENTURE PLC,APAC,2025-05-02,6,4,4,4,0
Platforms + Ecosystems,United States,"TRIPLE CROWN CONSULTING, LLC",NORTH AMERICA,2025-04-22,2,4,0,0,0
Cloud,United States,INFOSYS,NORTH AMERICA,2025-04-21,3,5,0,0,0
POps,India,RANDSTAD NV,APAC,2025-04-25,11,4,9,0,9
YouTube,India,ACCENTURE PLC,APAC,2025-04-27,8,5,5,2,3
Technical Infrastructure,null,SCHENKER,NORTH AMERICA,2025-04-24,3,3,0,0,0
Waymo,United States,TRANSDEV,NORTH AMERICA,2025-05-01,7,3,4,1,3
Technical Infrastructure,null,CERTIFIED MAINTENANCE SERVICE INC.,NORTH AMERICA,2025-04-21,3,5,0,0,0
REWS,India,G4S PLC,APAC,2025-04-24,1,1,0,0,0
Technical Infrastructure,United States,M A MORTENSON COMPANY,NORTH AMERICA,2025-04-25,7,5,4,2,2
T&S,Philippines,ACCENTURE PLC,APAC,2025-04-29,4,1,3,2,1
REWS,Israel,YARZIN SELLA MANAGEMENT AND HOLDINGS,EMEA,2025-05-02,3,3,0,0,0
Technical Infrastructure,United States,ANCHORBUOY LIMITED,NORTH AMERICA,2025-04-30,2,2,0,0,0
YouTube,Malaysia,ACCENTURE PLC,APAC,2025-04-28,3,2,1,1,0
Waymo,India,WIPRO LIMITED,APAC,2025-05-01,3,3,0,0,0
T&S,India,WIPRO LIMITED,APAC,2025-04-30,5,1,4,0,4
Access,United States,DELOITTE,NORTH AMERICA,2025-04-22,5,6,1,0,1
Google.org,United States,"TECHNOLOGY RESOURCE SOLUTIONS, INC. D/B/A SYNERGIS (VENDOR)",NORTH AMERICA,2025-04-30,6,3,3,1,2
REWS,Japan,JONES LANG LASALLE INC,APAC,2025-04-22,1,1,0,0,0
gCS,Philippines,CONCENTRIX,APAC,2025-04-30,2,2,0,0,0
YouTube,India,ACCENTURE PLC,APAC,2025-04-29,5,3,2,1,1
YouTube,India,ACCENTURE PLC,APAC,2025-04-24,8,4,4,1,3
DeepMind,United States,SCALE AI INC,NORTH AMERICA,2025-04-21,16,5,13,4,9
Waymo,United States,METRO ONE LOSS PREVENTION SERVICES GROUP (GUARD DIVISION) INC,NORTH AMERICA,2025-04-21,7,5,4,4,0
YouTube,Ireland,ACCENTURE PLC,EMEA,2025-04-23,4,5,1,0,1
Technical Infrastructure,United States,GXO LOGISTICS WORLDWIDE LLC,NORTH AMERICA,2025-04-29,5,3,2,1,1
Technical Infrastructure,United States,GXO LOGISTICS WORLDWIDE LLC,NORTH AMERICA,2025-04-28,2,4,0,0,0
Technical Infrastructure,United States,THE WHITING TURNER CONTRACTING COMPANY,NORTH AMERICA,2025-04-22,3,5,0,0,0
Cloud,El Salvador,CONCENTRIX,LATAM,2025-04-25,3,3,0,0,0
Cloud,El Salvador,CONCENTRIX,LATAM,2025-04-25,7,5,4,3,1
gCS,India,WNS (HOLDINGS) LIMITED,APAC,2025-04-24,3,1,2,1,1
gTech,India,TELEPERFORMANCE SE,APAC,2025-04-28,1,3,0,0,0
Cloud,United States,COGNIZANT TECHNOLOGY SOLUTIONS CORPORATION,NORTH AMERICA,2025-04-22,3,1,2,1,1
T&S,Portugal,COGNIZANT TECHNOLOGY SOLUTIONS CORPORATION,EMEA,2025-04-22,6,1,5,4,1
Geo,India,COGNIZANT TECHNOLOGY SOLUTIONS CORPORATION,APAC,2025-04-25,2,2,0,0,0
Technical Infrastructure,null,CERTIFIED MAINTENANCE SERVICE INC.,NORTH AMERICA,2025-04-21,3,5,0,0,0
gTech,India,COGNIZANT TECHNOLOGY SOLUTIONS CORPORATION,APAC,2025-05-01,3,3,0,0,0
Cloud,India,COGNIZANT TECHNOLOGY SOLUTIONS CORPORATION,APAC,2025-05-02,3,3,0,0,0
gCS,Brazil,ATENTO S.A.,LATAM,2025-04-29,3,5,0,0,0
REWS,India,JONES LANG LASALLE INC,APAC,2025-05-02,3,3,0,0,0
Technical Infrastructure,United States,GXO LOGISTICS WORLDWIDE LLC,NORTH AMERICA,2025-04-24,2,2,0,0,0
POps,United States,ACCENTURE PLC,NORTH AMERICA,2025-04-28,3,2,1,0,1
Cloud,Mexico,TATA GROUP,LATAM,2025-04-29,10,3,7,5,2
Devices & Services,United States,MOSAIC US HOLDINGS INC,NORTH AMERICA,2025-04-25,4,1,3,0,3
REWS,null,SODEXO,NORTH AMERICA,2025-04-28,3,5,0,0,0
Cloud,United States,TATA GROUP,NORTH AMERICA,2025-05-01,5,5,2,2,0
Access,United States,TELENETWORK PARTNERS LTD,NORTH AMERICA,2025-04-29,2,3,1,1,0
Technical Infrastructure,United Kingdom,CTORI CONSTRUCTION CONSULTANTS LIMITED,EMEA,2025-04-29,4,6,0,0,0
REWS,India,SODEXO,APAC,2025-04-23,1,1,0,0,0
Technical Infrastructure,Indonesia,G4S PLC,APAC,2025-04-21,5,4,2,2,0
Technical Infrastructure,null,"HOLDER CONSTRUCTION GROUP, LLC",NORTH AMERICA,2025-05-01,3,3,0,0,0
Technical Infrastructure,Finland,GXO LOGISTICS WORLDWIDE LLC,EMEA,2025-04-22,5,2,3,2,1
YouTube,Portugal,GENPACT LIMITED,EMEA,2025-04-30,5,2,3,2,1
Technical Infrastructure,United States,SCHENKER,NORTH AMERICA,2025-04-30,2,2,0,0,0
Waymo,United States,UBER TECHNOLOGIES INC,NORTH AMERICA,2025-04-24,3,2,1,0,1
YouTube,India,CONCENTRIX,APAC,2025-04-24,5,5,2,0,2
Technical Infrastructure,United States,ALLIED UNIVERSAL,NORTH AMERICA,2025-04-22,3,5,0,0,0
REWS,null,CONVERGINT TECHNOLOGIES GROUP L.P.,LATAM,2025-04-29,3,5,0,0,0
Cloud,Poland,EPAM SYSTEMS INC,EMEA,2025-04-24,2,1,1,0,1
T&S,Portugal,ACCENTURE PLC,EMEA,2025-04-30,10,2,8,2,6
YouTube,Poland,GENPACT LIMITED,EMEA,2025-04-22,10,2,8,1,7
gTech,Poland,TELEPERFORMANCE SE,EMEA,2025-04-28,3,5,0,0,0
Technical Infrastructure,United States,J E DUNN CONSTRUCTION COMPANY,NORTH AMERICA,2025-05-02,3,3,0,0,0
Technical Infrastructure,United States,DIRECT LINE GLOBAL LLC,NORTH AMERICA,2025-04-24,1,1,0,0,0
gCS,India,ACCENTURE PLC,APAC,2025-04-22,9,1,8,7,1
Technical Infrastructure,null,CERTIFIED MAINTENANCE SERVICE INC.,NORTH AMERICA,2025-04-21,3,5,0,0,0
gTech,India,GENPACT LIMITED,APAC,2025-04-24,2,1,1,1,0
REWS,India,COMPASS GROUP PLC,APAC,2025-04-29,4,6,0,0,0
Technical Infrastructure,United States,GXO LOGISTICS WORLDWIDE LLC,NORTH AMERICA,2025-04-25,11,4,9,5,4
Corp Eng,United States,ASTREYA PARTNERS INC,NORTH AMERICA,2025-04-28,4,2,2,2,0
REWS,United States,SUREFOX CONSULTING LLC,NORTH AMERICA,2025-04-29,2,3,1,0,1
REWS,United States,LUX BUS AMERICA CO,NORTH AMERICA,2025-04-28,3,5,0,0,0
gTech,India,VIRTUSA CORPORATION,APAC,2025-04-25,3,2,1,1,0
REWS,India,JONES LANG LASALLE INC,APAC,2025-04-25,4,4,0,0,0
Waymo,United States,METRO ONE LOSS PREVENTION SERVICES GROUP (GUARD DIVISION) INC,NORTH AMERICA,2025-04-23,5,5,2,0,2
gTech,Poland,TELEPERFORMANCE SE,EMEA,2025-04-28,3,5,0,0,0
REWS,United States,JONES LANG LASALLE INC,NORTH AMERICA,2025-04-28,1,3,0,0,0
Geo,India,WIPRO LIMITED,APAC,2025-04-28,2,4,0,0,0
Technical Infrastructure,null,C D MOODY CONSTRUCTION COMPANY INC,NORTH AMERICA,2025-04-24,3,3,0,0,0
Technical Infrastructure,null,"ROONEY HOLDINGS, INC.",NORTH AMERICA,2025-04-24,3,5,0,0,0
Technical Infrastructure,United States,GXO LOGISTICS WORLDWIDE LLC,NORTH AMERICA,2025-04-29,5,2,3,0,3
Geo,India,WIPRO LIMITED,APAC,2025-04-23,2,2,0,0,0
T&S,India,WIPRO LIMITED,APAC,2025-04-25,3,1,2,0,2
Devices & Services,India,TATA GROUP,APAC,2025-04-24,4,3,3,2,1
Waymo,India,WIPRO LIMITED,APAC,2025-04-30,6,1,5,0,5
Technical Infrastructure,null,SCHENKER,NORTH AMERICA,2025-04-21,3,5,0,0,0
HUE,United States,SCALENCE LLC,NORTH AMERICA,2025-04-21,3,5,0,0,0
gCS,India,WNS (HOLDINGS) LIMITED,APAC,2025-04-24,3,1,2,1,1
REWS,Taiwan,"LIANG PIN DINING CO., LTD.",APAC,2025-05-02,3,3,0,0,0
Waymo,United States,TRANSDEV,NORTH AMERICA,2025-05-01,7,3,4,1,3
Technical Infrastructure,United States,ALLIED UNIVERSAL,NORTH AMERICA,2025-04-25,3,2,1,0,1
Waymo,India,WIPRO LIMITED,APAC,2025-04-24,3,2,2,0,2
REWS,United States,GARDA WORLD SECURITY CORPORATION,NORTH AMERICA,2025-05-02,7,1,6,0,6
YouTube,Malaysia,CONCENTRIX,APAC,2025-04-24,11,2,9,0,9
gTech,United States,ADECCO GROUP AG,NORTH AMERICA,2025-04-21,5,7,0,0,0
Waymo,India,WIPRO LIMITED,APAC,2025-05-01,3,1,2,0,2
Finance,Philippines,ACCENTURE PLC,APAC,2025-04-21,2,1,1,1,0
Technical Infrastructure,United States,C D MOODY CONSTRUCTION COMPANY INC,NORTH AMERICA,2025-04-24,3,3,0,0,0
Technical Infrastructure,null,CERTIFIED MAINTENANCE SERVICE INC.,NORTH AMERICA,2025-05-01,3,3,0,0,0
REWS,India,JONES LANG LASALLE INC,APAC,2025-04-23,2,2,0,0,0
Ads & Commerce,United States,"SLALOM, LLC",NORTH AMERICA,2025-05-01,9,5,6,4,2
Technical Infrastructure,Singapore,LINESIGHT PTE LIMITED,APAC,2025-04-24,3,2,1,0,1
Waymo,India,WIPRO LIMITED,APAC,2025-05-01,3,1,2,2,0
Health,United States,"MEDAMERICA CONSULTING EMPLOYEES, INC.",NORTH AMERICA,2025-04-30,7,3,4,3,1
Global Affairs (w/o T&S),Spain,HERBERT SMITH FREEHILLS LLP,EMEA,2025-04-22,8,5,5,2,3
Geo,India,ACCENTURE PLC,APAC,2025-05-02,6,5,3,2,1
Geo,India,COGNIZANT TECHNOLOGY SOLUTIONS CORPORATION,APAC,2025-04-22,5,1,4,0,4
Technical Infrastructure,United States,"APEX INFRASTRUCTURE CONSULTANTS, LLC",NORTH AMERICA,2025-04-28,12,5,9,9,0
Technical Infrastructure,India,INDIGO TELECOM GROUP LTD,APAC,2025-05-01,3,3,0,0,0
Waymo,India,COGNIZANT TECHNOLOGY SOLUTIONS CORPORATION,APAC,2025-04-30,2,2,0,0,0
Geo,India,WIPRO LIMITED,APAC,2025-04-28,2,4,0,0,0
Access,United States,TELICS,NORTH AMERICA,2025-04-30,2,3,0,0,0
Waymo,India,COGNIZANT TECHNOLOGY SOLUTIONS CORPORATION,APAC,2025-04-21,1,3,0,0,0
Technical Infrastructure,United States,GXO LOGISTICS WORLDWIDE LLC,NORTH AMERICA,2025-04-24,2,2,0,0,0
Devices & Services,India,QUEST GLOBAL SERVICES PTE. LTD.,APAC,2025-04-25,3,3,0,0,0
Devices & Services,India,TESSOLVE SEMICONDUCTOR PVT LTD,APAC,2025-04-21,3,1,2,0,2
gTech,Portugal,TELEPERFORMANCE SE,EMEA,2025-04-21,6,5,3,1,2
Technical Infrastructure,United States,SCHENKER,NORTH AMERICA,2025-04-25,9,2,7,6,1
gTech,United Kingdom,SDL PLC,EMEA,2025-05-01,5,6,1,0,1
Technical Infrastructure,United States,SCHENKER,NORTH AMERICA,2025-04-25,6,1,5,4,1
T&S,India,ACCENTURE PLC,APAC,2025-04-28,3,1,0,0,0
Technical Infrastructure,United States,SCHENKER,NORTH AMERICA,2025-04-24,2,2,0,0,0
REWS,Taiwan,"LIANG PIN DINING CO., LTD.",APAC,2025-05-02,3,3,0,0,0
REWS,United States,COMPASS GROUP PLC,NORTH AMERICA,2025-04-22,1,1,0,0,0
Waymo,India,WIPRO LIMITED,APAC,2025-04-27,5,2,4,4,0
Cloud,El Salvador,TELUS,LATAM,2025-04-23,4,1,3,1,2
gTech,India,GENPACT LIMITED,APAC,2025-04-21,3,5,0,0,0
T&S,Ireland,ACCENTURE PLC,EMEA,2025-04-23,4,5,1,0,1
Global Affairs (w/o T&S),United States,AXIOM GLOBAL INC,NORTH AMERICA,2025-04-25,6,4,4,0,4
gTech,Poland,TELEPERFORMANCE SE,EMEA,2025-04-28,3,5,0,0,0
Technical Infrastructure,United States,DIRECT LINE GLOBAL LLC,NORTH AMERICA,2025-04-25,4,2,2,2,0
Technical Infrastructure,United States,GXO LOGISTICS WORLDWIDE LLC,NORTH AMERICA,2025-04-24,2,2,0,0,0
T&S,Costa Rica,TELEPERFORMANCE SE,LATAM,2025-04-30,5,5,2,1,1
gTech,India,TELEPERFORMANCE SE,APAC,2025-04-22,5,1,4,1,3
gTech,Portugal,COGNIZANT TECHNOLOGY SOLUTIONS CORPORATION,EMEA,2025-04-24,8,4,4,1,3
Cloud,United States,UBER TECHNOLOGIES INC,NORTH AMERICA,2025-04-22,6,3,3,0,3
Waymo,United States,MAGNA INTERNATIONAL INC.,NORTH AMERICA,2025-04-23,2,2,0,0,0
Cloud,Mexico,TATA GROUP,LATAM,2025-04-28,22,8,16,15,1
Cloud,Colombia,GLOBANT LLC,LATAM,2025-04-25,8,3,5,4,1
Waymo,India,COGNIZANT TECHNOLOGY SOLUTIONS CORPORATION,APAC,2025-04-21,1,3,0,0,0
Devices & Services,United States,ARCHLYNK LLC,NORTH AMERICA,2025-04-23,19,4,17,0,17
YouTube,India,CONCENTRIX,APAC,2025-04-25,5,4,3,0,3
T&S,India,COGNIZANT TECHNOLOGY SOLUTIONS CORPORATION,APAC,2025-04-27,8,2,6,0,6
Corp Eng,India,ASTREYA PARTNERS INC,APAC,2025-05-02,7,1,6,6,0
REWS,null,SYNERGY GLOBAL HOUSING LLC,NORTH AMERICA,2025-04-24,3,3,0,0,0
gCS,Philippines,CONCENTRIX,APAC,2025-04-30,2,2,0,0,0
Waymo,United States,TRANSDEV,NORTH AMERICA,2025-04-25,8,2,6,0,6
gCS,India,TELEDIRECT PTE LTD,APAC,2025-04-23,2,2,0,0,0
gTech,India,TECH MAHINDRA LIMITED,APAC,2025-04-27,3,2,1,1,0
Waymo,United States,TRANSDEV,NORTH AMERICA,2025-04-24,7,1,6,3,3
REWS,United States,ACCENTURE PLC,NORTH AMERICA,2025-04-30,4,5,1,1,0
YouTube,Poland,COGNIZANT TECHNOLOGY SOLUTIONS CORPORATION,EMEA,2025-04-22,14,2,12,12,0
REWS,India,G4S PLC,APAC,2025-04-29,3,5,0,0,0
REWS,null,CBRE GROUP INC,NORTH AMERICA,2025-04-21,3,5,0,0,0
REWS,null,COMPASS GROUP PLC,APAC,2025-04-21,3,5,0,0,0
Technical Infrastructure,United States,GARDA WORLD SECURITY CORPORATION,NORTH AMERICA,2025-04-22,1,1,1,0,1
Marketing,Utd.Arab Emir.,DIGITAL FUTURE MIDDLE EAST FZ-LLC,EMEA,2025-04-29,4,2,2,1,1
gTech,India,COGNIZANT TECHNOLOGY SOLUTIONS CORPORATION,APAC,2025-04-28,2,4,0,0,0
Platforms + Ecosystems,India,HCL TECHNOLOGIES LTD,APAC,2025-04-28,4,1,3,0,3
REWS,India,SODEXO,APAC,2025-04-24,3,3,0,0,0
Technical Infrastructure,United States,FORTIS CONSTRUCTION INC,NORTH AMERICA,2025-04-29,11,3,8,7,1
Technical Infrastructure,India,NIPPON TELEGRAPH AND TELEPHONE CORPORATION,APAC,2025-04-22,3,5,0,0,0
REWS,Poland,COMPASS GROUP PLC,EMEA,2025-04-29,1,1,0,0,0
REWS,Philippines,JONES LANG LASALLE INC,APAC,2025-04-24,2,2,0,0,0
Other Bets,United States,SCALENCE LLC,NORTH AMERICA,2025-04-24,4,4,2,1,1
Cloud,India,INFOSYS,APAC,2025-04-22,6,3,3,3,0
T&S,India,ACCENTURE PLC,APAC,2025-04-25,2,1,1,0,1
Waymo,United States,TRANSDEV,NORTH AMERICA,2025-05-02,8,2,6,0,6
YouTube,India,ACCENTURE PLC,APAC,2025-05-02,6,4,4,0,4
T&S,India,WIPRO LIMITED,APAC,2025-04-27,3,2,1,0,1
Technical Infrastructure,Denmark,QVISTGAARD IS,EMEA,2025-05-01,3,4,0,0,0
Access,India,VIRTUSA CORPORATION,APAC,2025-04-24,1,1,0,0,0
Technical Infrastructure,United States,SYNCREON GLOBAL HOLDINGS LIMITED,NORTH AMERICA,2025-05-02,10,5,7,7,0
Devices & Services,United States,MOSAIC US HOLDINGS INC,NORTH AMERICA,2025-04-29,4,2,2,1,1
gTech,Philippines,COGNIZANT TECHNOLOGY SOLUTIONS CORPORATION,APAC,2025-04-22,1,1,0,0,0
T&S,India,WIPRO LIMITED,APAC,2025-04-28,4,1,3,1,2
Technical Infrastructure,null,"HOLDER CONSTRUCTION GROUP, LLC",NORTH AMERICA,2025-05-02,3,3,0,0,0
Technical Infrastructure,United States,J E DUNN CONSTRUCTION COMPANY,NORTH AMERICA,2025-04-21,6,10,0,0,0
Ads & Commerce,India,"APPLAUSE APP QUALITY, INC",APAC,2025-04-28,5,8,0,0,0
Waymo,United States,TRANSDEV,NORTH AMERICA,2025-05-01,7,2,5,2,3
HUE,Poland,EPAM SYSTEMS INC,EMEA,2025-04-21,4,3,1,0,1
YouTube,India,CONCENTRIX,APAC,2025-04-24,5,1,4,0,4
Access,India,COGNIZANT TECHNOLOGY SOLUTIONS CORPORATION,APAC,2025-05-02,3,3,0,0,0
gTech,India,COGNIZANT TECHNOLOGY SOLUTIONS CORPORATION,APAC,2025-05-02,3,3,0,0,0
REWS,India,COMPASS GROUP PLC,APAC,2025-04-21,1,3,0,0,0
Technical Infrastructure,United States,SYNCREON GLOBAL HOLDINGS LIMITED,NORTH AMERICA,2025-04-21,3,2,1,1,0
Cloud,United States,GLOBANT LLC,NORTH AMERICA,2025-04-30,3,4,1,1,0
gCS,India,REGALIX INC,APAC,2025-04-24,3,3,0,0,0
gCS,India,WNS (HOLDINGS) LIMITED,APAC,2025-04-24,3,1,2,2,0
Devices & Services,India,WIPRO LIMITED,APAC,2025-04-27,8,null,8,0,8
gTech,India,TELEPERFORMANCE SE,APAC,2025-04-22,5,2,3,2,1
GBO (w/o gTech & gCS),United States,MOSAIC US HOLDINGS INC,NORTH AMERICA,2025-05-01,6,2,4,4,0
T&S,India,WIPRO LIMITED,APAC,2025-04-25,2,2,0,0,0
Waymo,India,WIPRO LIMITED,APAC,2025-04-30,2,1,1,1,0
gCS,India,TELEDIRECT PTE LTD,APAC,2025-04-21,5,3,2,2,0
T&S,United States,"MCAFEE, INC.",NORTH AMERICA,2025-05-02,7,2,5,0,5
Platforms + Ecosystems,United States,MAGIC LEAP INC.,NORTH AMERICA,2025-04-25,7,1,6,0,6
Cloud,Romania,COGNIZANT TECHNOLOGY SOLUTIONS CORPORATION,EMEA,2025-04-29,5,1,4,1,3
Technical Infrastructure,Israel,ASTREYA PARTNERS INC,EMEA,2025-04-23,9,1,8,1,7
T&S,India,WIPRO LIMITED,APAC,2025-04-30,5,2,3,1,2
REWS,United States,ISS A/S,NORTH AMERICA,2025-04-21,6,3,5,0,5
Technical Infrastructure,United States,SCHENKER,NORTH AMERICA,2025-04-30,7,2,5,4,1
gTech,null,QUALITEST,EMEA,2025-05-02,3,3,0,0,0
gCS,India,REGALIX INC,APAC,2025-04-23,2,1,1,1,0
REWS,India,MEDIFIT CONSULTANTS PVT LTD,APAC,2025-04-28,3,5,0,0,0
Cloud,United States,CONCENTRIX,NORTH AMERICA,2025-04-22,4,1,3,1,2
Search,India,PWC,APAC,2025-04-24,1,1,0,0,0
Technical Infrastructure,India,ASTREYA PARTNERS INC,APAC,2025-04-21,4,1,3,3,0
YouTube,India,ACCENTURE PLC,APAC,2025-04-24,5,1,4,1,3
Cloud,Philippines,ACCENTURE PLC,APAC,2025-05-02,6,5,3,3,0
Cloud,Mexico,TATA GROUP,LATAM,2025-05-02,16,4,14,10,4
Cloud,United States,MEDIATEK INC,NORTH AMERICA,2025-04-29,18,5,15,14,1
REWS,India,COMPASS GROUP PLC,APAC,2025-04-25,2,2,0,0,0
Technical Infrastructure,United States,TW CONSTRUCTORS LLC,NORTH AMERICA,2025-04-23,1,1,0,0,0
gTech,United States,VACO,NORTH AMERICA,2025-04-21,3,1,2,0,2
T&S,Malaysia,COGNIZANT TECHNOLOGY SOLUTIONS CORPORATION,APAC,2025-04-22,1,1,0,0,0
gTech,India,COGNIZANT TECHNOLOGY SOLUTIONS CORPORATION,APAC,2025-04-24,3,1,2,2,0
T&S,Portugal,COGNIZANT TECHNOLOGY SOLUTIONS CORPORATION,EMEA,2025-04-22,6,2,4,3,1
POps,India,RANDSTAD NV,APAC,2025-04-27,12,1,11,0,11
T&S,Philippines,ACCENTURE PLC,APAC,2025-04-21,7,1,6,5,1
YouTube,India,CONCENTRIX,APAC,2025-04-24,2,2,0,0,0
POps,United States,VACO,NORTH AMERICA,2025-04-29,2,3,1,1,0
gTech,Japan,ACCENTURE PLC,APAC,2025-04-21,5,2,3,1,2
Waymo,India,WIPRO LIMITED,APAC,2025-04-28,3,2,1,0,1
gCS,India,WNS (HOLDINGS) LIMITED,APAC,2025-04-24,3,1,2,1,1
GBO (w/o gTech & gCS),Brazil,COGNIZANT TECHNOLOGY SOLUTIONS CORPORATION,LATAM,2025-04-21,2,4,0,0,0
Technical Infrastructure,United States,TW CONSTRUCTORS LLC,NORTH AMERICA,2025-04-24,1,1,0,0,0
gCS,Philippines,CONCENTRIX,APAC,2025-04-25,3,1,2,1,1
REWS,India,JONES LANG LASALLE INC,APAC,2025-04-25,4,4,0,0,0
gTech,Ireland,TELUS,EMEA,2025-04-30,4,6,0,0,0
gCS,India,REGALIX INC,APAC,2025-04-25,4,3,1,1,0
YouTube,United States,TELEPERFORMANCE SE,NORTH AMERICA,2025-05-02,6,5,3,3,0
Technical Infrastructure,United States,GARDA WORLD SECURITY CORPORATION,NORTH AMERICA,2025-05-02,4,3,1,1,0
Corp Eng,T��rkiye,"THE UBERCLOUD, INC.",EMEA,2025-04-25,7,5,4,4,0
REWS,India,COMPASS GROUP PLC,APAC,2025-04-28,3,5,0,0,0
YouTube,India,ACCENTURE PLC,APAC,2025-04-21,6,3,5,0,5
Waymo,United States,TRANSDEV,NORTH AMERICA,2025-05-01,12,2,10,0,10
Waymo,India,COGNIZANT TECHNOLOGY SOLUTIONS CORPORATION,APAC,2025-04-22,2,3,1,0,1
Cloud,India,COGNIZANT TECHNOLOGY SOLUTIONS CORPORATION,APAC,2025-04-28,3,2,1,0,1
T&S,India,WIPRO LIMITED,APAC,2025-04-30,3,3,2,1,1
Technical Infrastructure,Netherlands,SYNCREON GLOBAL HOLDINGS LIMITED,EMEA,2025-04-24,2,1,1,1,0
Technical Infrastructure,null,"HOLDER CONSTRUCTION GROUP, LLC",NORTH AMERICA,2025-04-21,3,5,0,0,0
Waymo,United States,METRO ONE LOSS PREVENTION SERVICES GROUP (GUARD DIVISION) INC,NORTH AMERICA,2025-04-23,9,5,6,3,3
T&S,India,WIPRO LIMITED,APAC,2025-04-25,4,1,3,0,3
Technical Infrastructure,Netherlands,SECURITAS AB,EMEA,2025-04-30,6,1,5,3,2
T&S,India,WIPRO LIMITED,APAC,2025-04-30,3,3,2,0,2
Cloud,Greece,TELEPERFORMANCE SE,EMEA,2025-04-29,3,5,0,0,0
Technical Infrastructure,United States,MCFARLAND BUILDING GROUP LLC,NORTH AMERICA,2025-04-22,3,5,0,0,0
Devices & Services,India,CIENTRA TECHSOLUTION PVT LTD,APAC,2025-04-22,2,3,1,0,1
Technical Infrastructure,India,INDIGO TELECOM GROUP LTD,APAC,2025-04-29,1,1,0,0,0
Technical Infrastructure,Netherlands,EXYTE GMBH,EMEA,2025-04-28,4,1,3,2,1
REWS,United States,JONES LANG LASALLE INC,NORTH AMERICA,2025-04-22,4,1,3,0,3
T&S,India,WIPRO LIMITED,APAC,2025-04-25,3,1,2,0,2
YouTube,India,GENPACT LIMITED,APAC,2025-04-28,3,2,1,0,1
Technical Infrastructure,United States,ALLIED UNIVERSAL,NORTH AMERICA,2025-04-28,4,3,1,0,1
gTech,India,TELEPERFORMANCE SE,APAC,2025-04-22,5,3,2,1,1
YouTube,India,GENPACT LIMITED,APAC,2025-04-28,3,2,1,1,0
T&S,India,WIPRO LIMITED,APAC,2025-04-29,2,3,1,0,1
REWS,United States,COMPASS GROUP PLC,NORTH AMERICA,2025-04-23,2,2,0,0,0
gTech,Colombia,CONCENTRIX,LATAM,2025-04-25,2,2,0,0,0
Ads & Commerce,India,TELEPERFORMANCE SE,APAC,2025-04-23,5,2,3,0,3
Cloud,United States,DELOITTE,NORTH AMERICA,2025-05-01,3,1,2,0,2
REWS,null,COMPASS GROUP PLC,APAC,2025-04-21,3,5,0,0,0
Technical Infrastructure,United States,"HOLDER CONSTRUCTION GROUP, LLC",NORTH AMERICA,2025-04-29,3,5,0,0,0
Technical Infrastructure,null,SCHENKER,NORTH AMERICA,2025-04-21,3,5,0,0,0
T&S,Philippines,ACCENTURE PLC,APAC,2025-04-21,5,1,4,0,4
Technical Infrastructure,United States,SCHENKER,NORTH AMERICA,2025-04-29,6,2,4,3,1
Technical Infrastructure,United States,GXO LOGISTICS WORLDWIDE LLC,NORTH AMERICA,2025-04-22,10,3,7,0,7
Technical Infrastructure,United States,GXO LOGISTICS WORLDWIDE LLC,NORTH AMERICA,2025-04-22,5,2,3,2,1
gTech,India,TELEPERFORMANCE SE,APAC,2025-04-28,10,2,8,2,6
Geo,India,WIPRO LIMITED,APAC,2025-04-25,4,3,1,0,1
Technical Infrastructure,United States,FORTIS CONSTRUCTION INC,NORTH AMERICA,2025-04-28,10,3,7,7,0
gCS,India,REGALIX INC,APAC,2025-04-24,3,2,1,1,0
Technical Infrastructure,United States,GXO LOGISTICS WORLDWIDE LLC,NORTH AMERICA,2025-04-21,4,2,2,1,1
YouTube,India,ACCENTURE PLC,APAC,2025-04-29,4,2,2,0,2
REWS,India,JONES LANG LASALLE INC,APAC,2025-04-23,2,2,0,0,0
REWS,null,SODEXO,APAC,2025-05-02,3,3,0,0,0
Access,United States,SORENSEN CRAIG F CONSTRUCTION INC,NORTH AMERICA,2025-04-21,18,8,12,3,9
Core (w/o Corp Eng),Philippines,INFOSYS,APAC,2025-04-29,5,3,2,1,1
REWS,India,JONES LANG LASALLE INC,APAC,2025-04-23,2,2,0,0,0
Platforms + Ecosystems,United States,MILESTONE TECHNOLOGIES INC,NORTH AMERICA,2025-05-01,3,2,1,0,1
Cloud,Spain,CONCENTRIX,EMEA,2025-04-28,3,5,0,0,0
REWS,India,JONES LANG LASALLE INC,APAC,2025-05-02,3,3,0,0,0
REWS,India,JONES LANG LASALLE INC,APAC,2025-04-22,1,1,0,0,0
Technical Infrastructure,Netherlands,GXO LOGISTICS WORLDWIDE LLC,EMEA,2025-04-22,5,2,3,1,2
Technical Infrastructure,United States,"HOLDER CONSTRUCTION GROUP, LLC",NORTH AMERICA,2025-05-02,3,3,0,0,0
Ads & Commerce,India,GLOBALLOGIC INC,APAC,2025-04-22,1,1,0,0,0
Waymo,India,WIPRO LIMITED,APAC,2025-04-24,3,2,2,1,1
Corp Eng,null,LARSEN AND TOUBRO LIMITED,APAC,2025-04-22,3,5,0,0,0
T&S,Malaysia,ACCENTURE PLC,APAC,2025-04-29,4,2,2,0,2
Devices & Services,India,TECH MAHINDRA LIMITED,APAC,2025-04-28,9,1,8,0,8
REWS,United States,PROPARK AMERICA WEST LLC,NORTH AMERICA,2025-04-28,2,4,0,0,0
POps,India,RANDSTAD NV,APAC,2025-04-30,14,4,12,0,12
POps,China,DELOITTE,APAC,2025-04-28,3,5,0,0,0
Platforms + Ecosystems,India,HCL TECHNOLOGIES LTD,APAC,2025-04-29,5,2,3,3,0
gTech,Ireland,ACCENTURE PLC,EMEA,2025-04-24,7,3,4,1,3
Technical Infrastructure,United States,ASTREYA PARTNERS INC,NORTH AMERICA,2025-04-21,4,3,1,0,1
gTech,Poland,TELEPERFORMANCE SE,EMEA,2025-04-28,3,5,0,0,0
T&S,India,COGNIZANT TECHNOLOGY SOLUTIONS CORPORATION,APAC,2025-04-27,5,1,4,2,2
gTech,India,GLOBALLOGIC INC,APAC,2025-04-24,3,3,0,0,0
Waymo,United States,"TASKUS, INC.",NORTH AMERICA,2025-04-21,4,3,1,0,1
Technical Infrastructure,United States,"HOLDER CONSTRUCTION GROUP, LLC",NORTH AMERICA,2025-04-30,2,2,0,0,0
Technical Infrastructure,United States,M A MORTENSON COMPANY,NORTH AMERICA,2025-04-28,1,3,0,0,0
Technical Infrastructure,null,J E DUNN CONSTRUCTION COMPANY,NORTH AMERICA,2025-04-30,3,5,0,0,0
Technical Infrastructure,null,"HOLDER CONSTRUCTION GROUP, LLC",NORTH AMERICA,2025-04-22,3,5,0,0,0
Devices & Services,Taiwan,WIPRO LIMITED,APAC,2025-04-25,4,3,1,1,0
Technical Infrastructure,United States,GXO LOGISTICS WORLDWIDE LLC,NORTH AMERICA,2025-04-28,4,3,1,1,0
Platforms + Ecosystems,United States,BAYONE SOLUTIONS INC.,NORTH AMERICA,2025-05-02,5,5,2,1,1
YouTube,Portugal,COGNIZANT TECHNOLOGY SOLUTIONS CORPORATION,EMEA,2025-04-22,6,2,4,3,1
YouTube,Portugal,COGNIZANT TECHNOLOGY SOLUTIONS CORPORATION,EMEA,2025-04-22,6,2,4,3,1
POps,India,RANDSTAD NV,APAC,2025-04-27,8,null,8,1,7
gTech,India,CONCENTRIX,APAC,2025-04-22,4,5,1,0,1
Technical Infrastructure,United States,J E DUNN CONSTRUCTION COMPANY,NORTH AMERICA,2025-04-23,2,2,0,0,0
DeepMind,United States,SCALE AI INC,NORTH AMERICA,2025-04-21,20,3,17,0,17
Technical Infrastructure,United States,SCHENKER,NORTH AMERICA,2025-04-25,9,4,5,4,1
Finance,null,HCL TECHNOLOGIES LTD,NORTH AMERICA,2025-05-02,3,3,0,0,0
Technical Infrastructure,Indonesia,G4S PLC,APAC,2025-04-22,1,2,0,0,0
YouTube,Philippines,COGNIZANT TECHNOLOGY SOLUTIONS CORPORATION,APAC,2025-04-28,5,1,4,0,4
gTech,India,VIRTUSA CORPORATION,APAC,2025-04-25,3,2,1,0,1
T&S,Ireland,ACCENTURE PLC,EMEA,2025-04-23,4,5,1,0,1
Search,India,GLOBALLOGIC INC,APAC,2025-05-02,3,3,0,0,0
Technical Infrastructure,India,ASTREYA PARTNERS INC,APAC,2025-04-21,3,1,2,2,0
Geo,India,ACCENTURE PLC,APAC,2025-04-24,3,1,2,2,0
Corp Eng,India,MOVATE TECHNOLOGIES PRIVATE LIMITED,APAC,2025-04-21,4,2,2,0,2
Waymo,United States,TRANSDEV,NORTH AMERICA,2025-05-01,7,3,4,1,3
Platforms + Ecosystems,United States,"PURPLE, ROCK, SCISSORS LLC",NORTH AMERICA,2025-04-24,6,2,4,0,4
T&S,India,ACCENTURE PLC,APAC,2025-04-25,4,2,2,0,2
Waymo,India,WIPRO LIMITED,APAC,2025-04-30,6,1,5,5,0
Technical Infrastructure,United States,"KOR BUILDING GROUP, LLC",NORTH AMERICA,2025-04-29,8,5,5,4,1
Cloud,Brazil,ACCENTURE PLC,LATAM,2025-04-28,2,4,0,0,0
Devices & Services,United States,SIEMENS AG,NORTH AMERICA,2025-04-28,6,6,2,2,0
Devices & Services,India,HCL TECHNOLOGIES LTD,APAC,2025-04-23,2,2,0,0,0
REWS,United States,JOHNSON CONTROLS INTERNATIONAL PLC,NORTH AMERICA,2025-05-01,462,6,458,445,13
T&S,India,WIPRO LIMITED,APAC,2025-04-27,3,2,1,0,1
REWS,India,G4S PLC,APAC,2025-04-28,3,5,0,0,0
Global Affairs (w/o T&S),India,ACCENTURE PLC,APAC,2025-04-29,4,1,3,2,1
Technical Infrastructure,United States,GXO LOGISTICS WORLDWIDE LLC,NORTH AMERICA,2025-04-24,2,2,0,0,0
gCS,India,ACCENTURE PLC,APAC,2025-04-22,12,6,8,7,1
T&S,Portugal,COGNIZANT TECHNOLOGY SOLUTIONS CORPORATION,EMEA,2025-04-22,6,1,5,1,4
Technical Infrastructure,null,SISTEMAS CONTRA INCENDIOS EUROCOMERCIAL LTDA,LATAM,2025-04-28,3,5,0,0,0
gTech,Portugal,COGNIZANT TECHNOLOGY SOLUTIONS CORPORATION,EMEA,2025-04-22,6,2,4,3,1
YouTube,India,ACCENTURE PLC,APAC,2025-04-21,6,3,5,0,5
REWS,India,COMPASS GROUP PLC,APAC,2025-04-28,3,5,0,0,0
gCS,India,REGALIX INC,APAC,2025-04-27,5,3,2,2,0
YouTube,Poland,COGNIZANT TECHNOLOGY SOLUTIONS CORPORATION,EMEA,2025-04-30,5,5,2,1,1
Cloud,Spain,TELEPERFORMANCE SE,EMEA,2025-04-28,3,5,0,0,0
gTech,India,TELEPERFORMANCE SE,APAC,2025-04-21,5,1,4,2,2
Technical Infrastructure,United States,AMENTUM COMMERCIAL OPERATIONS INC,NORTH AMERICA,2025-04-23,2,1,1,0,1
YouTube,India,CONCENTRIX,APAC,2025-04-27,4,1,3,3,0
Devices & Services,India,WNS (HOLDINGS) LIMITED,APAC,2025-04-30,9,4,7,6,1
Waymo,India,WIPRO LIMITED,APAC,2025-04-24,3,4,0,0,0
Cloud,India,SERVICESOURCE INTERNATIONAL INC,APAC,2025-04-30,2,3,0,0,0
T&S,India,COGNIZANT TECHNOLOGY SOLUTIONS CORPORATION,APAC,2025-04-24,2,1,1,1,0
gTech,India,TECH MAHINDRA LIMITED,APAC,2025-04-27,3,2,1,1,0
Cloud,Philippines,ACCENTURE PLC,APAC,2025-04-24,7,3,4,0,4
REWS,Colombia,G4S PLC,LATAM,2025-04-25,3,3,0,0,0
Waymo,India,WIPRO LIMITED,APAC,2025-04-27,4,1,3,0,3
Finance,India,IBM CORPORATION,APAC,2025-04-29,8,1,7,1,6
T&S,India,WIPRO LIMITED,APAC,2025-04-25,4,3,1,0,1
Cloud,India,INNODATA INC.,APAC,2025-04-29,4,1,3,0,3
Technical Infrastructure,United States,GXO LOGISTICS WORLDWIDE LLC,NORTH AMERICA,2025-04-28,4,3,1,1,0
T&S,Philippines,"TASKUS, INC.",APAC,2025-04-22,3,5,0,0,0
Geo,India,TECH MAHINDRA LIMITED,APAC,2025-04-21,9,2,7,0,7
T&S,India,WIPRO LIMITED,APAC,2025-05-02,3,3,0,0,0
GBO (w/o gTech & gCS),India,ACCENTURE PLC,APAC,2025-04-23,2,1,1,0,1
T&S,India,WIPRO LIMITED,APAC,2025-05-01,6,5,3,0,3
gTech,India,TECH MAHINDRA LIMITED,APAC,2025-04-28,2,1,1,0,1
REWS,Spain,PROSEGUR SA,EMEA,2025-04-24,2,1,1,0,1
Waymo,India,COGNIZANT TECHNOLOGY SOLUTIONS CORPORATION,APAC,2025-04-23,1,1,0,0,0
Technical Infrastructure,United States,GARDA WORLD SECURITY CORPORATION,NORTH AMERICA,2025-04-21,4,1,3,1,2
Waymo,India,WIPRO LIMITED,APAC,2025-04-23,6,1,5,1,4
Technical Infrastructure,Argentina,ACCENTURE PLC,LATAM,2025-04-28,3,1,2,0,2
GBO (w/o gTech & gCS),United States,HCL TECHNOLOGIES LTD,NORTH AMERICA,2025-04-23,4,4,2,0,2
gTech,Poland,COGNIZANT TECHNOLOGY SOLUTIONS CORPORATION,EMEA,2025-04-30,5,1,4,0,4
REWS,India,JONES LANG LASALLE INC,APAC,2025-04-25,4,4,0,0,0
Finance,Philippines,ACCENTURE PLC,APAC,2025-04-29,4,1,3,0,3
gTech,Philippines,TELUS,APAC,2025-04-23,3,4,1,0,1
Waymo,null,ABM INDUSTRIES INCORPORATED,NORTH AMERICA,2025-04-29,3,5,0,0,0
Waymo,India,WIPRO LIMITED,APAC,2025-04-27,4,1,3,0,3
REWS,India,COMPASS GROUP PLC,APAC,2025-04-22,4,1,3,0,3
T&S,India,WIPRO LIMITED,APAC,2025-04-25,2,2,0,0,0
Technical Infrastructure,United States,GARDA WORLD SECURITY CORPORATION,NORTH AMERICA,2025-04-24,3,2,1,0,1
Cloud,El Salvador,TELUS,LATAM,2025-05-02,4,3,1,1,0
Waymo,United States,TRANSDEV,NORTH AMERICA,2025-04-23,11,3,8,1,7
gCS,India,TELEDIRECT PTE LTD,APAC,2025-04-30,7,4,3,3,0
T&S,India,WIPRO LIMITED,APAC,2025-04-25,2,1,1,0,1
Cloud,India,ACCENTURE PLC,APAC,2025-04-28,5,2,3,1,2
Marketing,United States,THE SAGE GROUP,NORTH AMERICA,2025-04-29,4,5,1,1,0
REWS,India,JONES LANG LASALLE INC,APAC,2025-05-02,3,3,0,0,0
Technical Infrastructure,Netherlands,SYNCREON GLOBAL HOLDINGS LIMITED,EMEA,2025-04-29,5,1,4,2,2
Technical Infrastructure,United States,DIRECT LINE GLOBAL LLC,NORTH AMERICA,2025-04-24,4,3,3,3,0
Cloud,Greece,TELEPERFORMANCE SE,EMEA,2025-05-01,3,3,0,0,0
gCS,India,TELEDIRECT PTE LTD,APAC,2025-04-25,4,3,1,1,0
Cloud,India,TECH MAHINDRA LIMITED,APAC,2025-04-21,2,1,1,1,0
Technical Infrastructure,United States,SCHENKER,NORTH AMERICA,2025-04-24,7,1,6,6,0
Devices & Services,United States,"ANSYS, INC.",NORTH AMERICA,2025-04-28,5,3,2,0,2
Marketing,India,ACCENTURE PLC,APAC,2025-04-22,4,5,1,1,0
gTech,India,TELEPERFORMANCE SE,APAC,2025-04-22,5,2,3,1,2
gTech,Mexico,QUALITEST,LATAM,2025-04-29,6,3,3,0,3
Cloud,United States,TECH MAHINDRA LIMITED,NORTH AMERICA,2025-04-28,3,5,0,0,0
T&S,India,WIPRO LIMITED,APAC,2025-04-25,3,1,2,1,1
gTech,Japan,COGNIZANT TECHNOLOGY SOLUTIONS CORPORATION,APAC,2025-04-25,6,1,5,5,0
YouTube,United States,"MAGNIT, LLC",NORTH AMERICA,2025-04-23,36,55,2,0,2
Devices & Services,United States,"SYNOPSYS, INC",NORTH AMERICA,2025-04-23,12,4,8,7,1
Waymo,United States,METRO ONE LOSS PREVENTION SERVICES GROUP (GUARD DIVISION) INC,NORTH AMERICA,2025-04-21,6,5,3,1,2
gCS,India,TELEDIRECT PTE LTD,APAC,2025-04-25,4,3,1,1,0
Finance,Ireland,KPMG,EMEA,2025-04-23,4,5,1,0,1
Technical Infrastructure,United Kingdom,TURNER & TOWNSEND PARTNERS LLP,EMEA,2025-04-23,8,4,6,1,5
Technical Infrastructure,United States,ALLIED UNIVERSAL,NORTH AMERICA,2025-04-24,9,4,7,6,1
Core (w/o Corp Eng),United States,"AKRAYA, INC",NORTH AMERICA,2025-04-23,4,4,2,2,0
Technical Infrastructure,Netherlands,SYNCREON GLOBAL HOLDINGS LIMITED,EMEA,2025-04-30,6,3,3,3,0
Technical Infrastructure,United States,ADECCO GROUP AG,NORTH AMERICA,2025-04-30,15,7,12,12,0
gTech,Portugal,CONCENTRIX,EMEA,2025-04-22,4,5,1,1,0
REWS,United States,BODY TECHNIQUES LLC,NORTH AMERICA,2025-04-28,8,5,5,1,4
Technical Infrastructure,United States,ADECCO GROUP AG,NORTH AMERICA,2025-04-29,111,10,0,0,0
REWS,United States,JONES LANG LASALLE INC,NORTH AMERICA,2025-04-23,5,2,3,3,0
REWS,India,SODEXO,APAC,2025-04-22,1,1,0,0,0
Technical Infrastructure,United States,MOTIVITY LABS INC,NORTH AMERICA,2025-04-22,5,2,3,3,0
Technical Infrastructure,United States,GARDA WORLD SECURITY CORPORATION,NORTH AMERICA,2025-04-30,2,1,1,1,0
Geo,India,EPAM SYSTEMS INC,APAC,2025-04-24,3,3,0,0,0
Technical Infrastructure,United States,GXO LOGISTICS WORLDWIDE LLC,NORTH AMERICA,2025-04-28,4,2,2,0,2
Waymo,United States,TEZERAKT LLC,NORTH AMERICA,2025-05-01,5,5,2,0,2
Waymo,India,WIPRO LIMITED,APAC,2025-04-24,3,3,1,1,0
Devices & Services,United States,"CADENCE DESIGN SYSTEMS, INC.",NORTH AMERICA,2025-04-29,3,4,1,1,0
Waymo,India,COGNIZANT TECHNOLOGY SOLUTIONS CORPORATION,APAC,2025-04-21,1,3,0,0,0
gCS,Brazil,TTEC HOLDINGS INC,LATAM,2025-04-28,5,4,1,0,1
Technical Infrastructure,United States,SCHENKER,NORTH AMERICA,2025-04-23,4,6,0,0,0
REWS,United States,"SLALOM, LLC",NORTH AMERICA,2025-04-27,3,1,2,2,0
Technical Infrastructure,United States,GXO LOGISTICS WORLDWIDE LLC,NORTH AMERICA,2025-04-29,5,2,3,0,3
Devices & Services,India,QUEST GLOBAL SERVICES PTE. LTD.,APAC,2025-04-25,3,3,0,0,0
gTech,Brazil,COGNIZANT TECHNOLOGY SOLUTIONS CORPORATION,LATAM,2025-04-25,3,2,1,0,1
POps,India,ACCENTURE PLC,APAC,2025-04-21,5,2,3,3,0
Technical Infrastructure,United States,"HOLDER CONSTRUCTION GROUP, LLC",NORTH AMERICA,2025-04-23,1,1,0,0,0
T&S,India,WIPRO LIMITED,APAC,2025-04-27,4,2,2,0,2
gTech,India,COGNIZANT TECHNOLOGY SOLUTIONS CORPORATION,APAC,2025-05-01,3,3,0,0,0
gTech,United States,VACO,NORTH AMERICA,2025-04-21,3,1,2,2,0
YouTube,India,WIPRO LIMITED,APAC,2025-04-24,3,1,2,2,0
YouTube,United States,"MAGNIT, LLC",NORTH AMERICA,2025-05-01,6,7,3,0,3
gTech,India,TELEPERFORMANCE SE,APAC,2025-04-28,3,5,0,0,0
POps,India,KORN FERRY INTERNATIONAL,APAC,2025-04-24,3,1,2,2,0
Corp Eng,Philippines,ASTREYA PARTNERS INC,APAC,2025-04-28,3,2,1,0,1
Core (w/o Corp Eng),Poland,INVISIBLE THINGS LAB GMBH,EMEA,2025-04-30,9,1,8,1,7
Ads & Commerce,India,"APPLAUSE APP QUALITY, INC",APAC,2025-04-28,5,8,0,0,0
Technical Infrastructure,null,"HOLDER CONSTRUCTION GROUP, LLC",NORTH AMERICA,2025-04-23,3,5,0,0,0
gTech,India,COGNIZANT TECHNOLOGY SOLUTIONS CORPORATION,APAC,2025-04-22,4,2,2,2,0
YouTube,Romania,GENPACT LIMITED,EMEA,2025-04-29,5,6,1,0,1
Cloud,Philippines,ACCENTURE PLC,APAC,2025-04-21,6,3,5,0,5
gCS,India,REGALIX INC,APAC,2025-04-25,4,3,1,1,0
gTech,India,ACCENTURE PLC,APAC,2025-04-21,4,1,3,0,3
Marketing,India,CONTINUUMGLOBAL INC,APAC,2025-04-23,2,1,1,0,1
Technical Infrastructure,United States,"ROONEY HOLDINGS, INC.",NORTH AMERICA,2025-05-01,3,3,0,0,0
Technical Infrastructure,United States,SKYBOX CRITICAL OPERATIONS LLC,NORTH AMERICA,2025-04-24,3,3,0,0,0
Geo,India,WIPRO LIMITED,APAC,2025-04-23,2,1,1,0,1
REWS,India,JONES LANG LASALLE INC,APAC,2025-04-22,1,1,0,0,0
gTech,India,TELEPERFORMANCE SE,APAC,2025-04-28,5,3,2,2,0
YouTube,India,CONCENTRIX,APAC,2025-05-01,3,3,0,0,0
Technical Infrastructure,United States,GXO LOGISTICS WORLDWIDE LLC,NORTH AMERICA,2025-04-25,6,4,4,4,0
REWS,Philippines,JONES LANG LASALLE INC,APAC,2025-04-29,1,1,0,0,0
Technical Infrastructure,null,SCHENKER,NORTH AMERICA,2025-04-24,3,3,0,0,0
gTech,India,COGNIZANT TECHNOLOGY SOLUTIONS CORPORATION,APAC,2025-05-01,3,3,0,0,0
Devices & Services,India,QUEST GLOBAL SERVICES PTE. LTD.,APAC,2025-04-23,5,7,0,0,0
Technical Infrastructure,United Kingdom,ARCADIS NV,EMEA,2025-05-01,7,3,4,3,1
gTech,India,COGNIZANT TECHNOLOGY SOLUTIONS CORPORATION,APAC,2025-05-02,3,3,0,0,0
YouTube,India,CONCENTRIX,APAC,2025-04-21,3,2,1,1,0
gCS,Philippines,CONCENTRIX,APAC,2025-04-21,5,7,0,0,0
Cloud,India,TECH MAHINDRA LIMITED,APAC,2025-05-01,5,5,2,1,1
REWS,United States,JONES LANG LASALLE INC,NORTH AMERICA,2025-04-21,13,5,10,8,2
Waymo,United States,METRO ONE LOSS PREVENTION SERVICES GROUP (GUARD DIVISION) INC,NORTH AMERICA,2025-04-23,3,3,2,0,2
Technical Infrastructure,United States,GXO LOGISTICS WORLDWIDE LLC,NORTH AMERICA,2025-05-02,3,3,0,0,0
gTech,Germany,VACO,EMEA,2025-04-21,3,5,0,0,0
Cloud,India,DELOITTE,APAC,2025-04-24,4,3,3,0,3
REWS,United States,ELECTROSONIC LIMITED,NORTH AMERICA,2025-04-23,4,6,0,0,0
YouTube,Portugal,GENPACT LIMITED,EMEA,2025-05-02,9,3,6,4,2
REWS,United Kingdom,CBRE GROUP INC,EMEA,2025-05-02,3,3,0,0,0
Technical Infrastructure,United States,SCHENKER,NORTH AMERICA,2025-04-29,1,1,0,0,0
gCS,India,ACCENTURE PLC,APAC,2025-04-25,14,2,12,6,6
gCS,India,ACCENTURE PLC,APAC,2025-04-25,3,1,2,0,2
Technical Infrastructure,United States,ALLIED UNIVERSAL,NORTH AMERICA,2025-04-28,16,20,2,1,1
Technical Infrastructure,United States,ALLIED UNIVERSAL,NORTH AMERICA,2025-04-25,3,3,0,0,0
Technical Infrastructure,United States,SYNCREON GLOBAL HOLDINGS LIMITED,NORTH AMERICA,2025-04-22,3,4,1,1,0
gCS,India,REGALIX INC,APAC,2025-04-25,4,3,1,1,0
REWS,India,SODEXO,APAC,2025-04-23,2,2,0,0,0
T&S,India,WIPRO LIMITED,APAC,2025-04-30,5,2,3,1,2
Platforms + Ecosystems,United States,SCALENCE LLC,NORTH AMERICA,2025-04-24,2,2,0,0,0
Technical Infrastructure,United States,"HOLDER CONSTRUCTION GROUP, LLC",NORTH AMERICA,2025-04-30,2,2,0,0,0
DeepMind,Germany,SCALE AI INC,EMEA,2025-04-21,13,6,9,0,9
Core (w/o Corp Eng),India,ACCENTURE PLC,APAC,2025-04-28,5,1,4,4,0
Technical Infrastructure,United States,TATA GROUP,NORTH AMERICA,2025-04-21,3,5,0,0,0
gCS,India,ACCENTURE PLC,APAC,2025-04-30,6,2,4,4,0
Devices & Services,United States,MOSAIC US HOLDINGS INC,NORTH AMERICA,2025-04-30,12,4,8,0,8
GBO (w/o gTech & gCS),United States,"MAGNIT, LLC",NORTH AMERICA,2025-04-28,9,11,4,0,4
Geo,India,COGNIZANT TECHNOLOGY SOLUTIONS CORPORATION,APAC,2025-05-02,3,3,0,0,0
Finance,Philippines,ACCENTURE PLC,APAC,2025-04-25,1,1,0,0,0
Geo,India,COGNIZANT TECHNOLOGY SOLUTIONS CORPORATION,APAC,2025-04-30,2,2,0,0,0
T&S,Philippines,ACCENTURE PLC,APAC,2025-04-21,5,1,4,0,4
POps,United Kingdom,KORN FERRY INTERNATIONAL,EMEA,2025-04-25,3,2,1,1,0
REWS,United Kingdom,CBRE GROUP INC,EMEA,2025-04-28,4,6,0,0,0
gTech,Japan,ACCENTURE PLC,APAC,2025-04-21,5,2,3,0,3
Devices & Services,United States,NEUSOFT AMERICA INC,NORTH AMERICA,2025-04-25,6,5,3,0,3
gCS,India,TELEDIRECT PTE LTD,APAC,2025-04-22,7,10,1,0,1
REWS,India,JONES LANG LASALLE INC,APAC,2025-04-21,4,6,0,0,0
gCS,India,ACCENTURE PLC,APAC,2025-04-22,5,1,4,1,3
Technical Infrastructure,Netherlands,SECURITAS AB,EMEA,2025-04-24,2,2,0,0,0
Technical Infrastructure,United States,"ROONEY HOLDINGS, INC.",NORTH AMERICA,2025-04-29,3,5,0,0,0
T&S,India,ACCENTURE PLC,APAC,2025-04-21,4,1,3,2,1
YouTube,India,GENPACT LIMITED,APAC,2025-04-28,3,2,1,0,1
Cloud,India,DELOITTE,APAC,2025-04-24,4,3,3,0,3
gTech,Argentina,COGNIZANT TECHNOLOGY SOLUTIONS CORPORATION,LATAM,2025-04-29,14,2,12,2,10
gCS,India,TELEDIRECT PTE LTD,APAC,2025-04-29,6,7,1,1,0
Technical Infrastructure,United States,ALLIED UNIVERSAL,NORTH AMERICA,2025-04-23,5,5,2,2,0
T&S,India,WIPRO LIMITED,APAC,2025-04-28,4,1,3,1,2
REWS,Ireland,COMPASS GROUP PLC,EMEA,2025-04-29,3,5,0,0,0
gCS,United States,COGNIZANT TECHNOLOGY SOLUTIONS CORPORATION,NORTH AMERICA,2025-05-02,3,3,0,0,0
POps,United States,RANDSTAD NV,NORTH AMERICA,2025-04-28,17,5,14,12,2
DeepMind,United States,SCALE AI INC,NORTH AMERICA,2025-04-21,17,1,16,0,16
REWS,United States,"INTER-CON SECURITY SYSTEMS, INC.",NORTH AMERICA,2025-04-23,4,6,0,0,0
REWS,United States,COMPASS GROUP PLC,NORTH AMERICA,2025-04-22,6,2,4,3,1
Waymo,India,COGNIZANT TECHNOLOGY SOLUTIONS CORPORATION,APAC,2025-04-27,4,1,3,3,0
Technical Infrastructure,United States,"ROONEY HOLDINGS, INC.",NORTH AMERICA,2025-04-29,3,5,0,0,0
Platforms + Ecosystems,United States,"THE BLUE DOT LABS, LLC",NORTH AMERICA,2025-04-21,12,5,9,3,6
Waymo,United States,TRANSDEV,NORTH AMERICA,2025-04-24,7,3,4,1,3
REWS,null,COMPASS GROUP PLC,APAC,2025-04-21,3,5,0,0,0
gCS,India,TELEDIRECT PTE LTD,APAC,2025-04-25,4,3,1,1,0
gTech,India,COGNIZANT TECHNOLOGY SOLUTIONS CORPORATION,APAC,2025-04-21,4,3,1,0,1
T&S,India,WIPRO LIMITED,APAC,2025-04-23,8,5,5,0,5
Technical Infrastructure,Singapore,NIPPON TELEGRAPH AND TELEPHONE CORPORATION,APAC,2025-04-30,1,1,0,0,0
Technical Infrastructure,United States,DIRECT LINE GLOBAL LLC,NORTH AMERICA,2025-04-29,2,4,0,0,0
REWS,India,JAGUAR SECURITY SERVICES PVT. LTD.,APAC,2025-04-23,1,1,0,0,0
YouTube,India,CONCENTRIX,APAC,2025-04-24,5,5,2,0,2
DeepMind,United States,SCALE AI INC,NORTH AMERICA,2025-04-21,21,5,18,1,17
gTech,India,TELEPERFORMANCE SE,APAC,2025-04-24,7,1,6,6,0
Marketing,United States,ACCENTURE PLC,NORTH AMERICA,2025-04-24,4,3,3,3,0
Technical Infrastructure,United States,GXO LOGISTICS WORLDWIDE LLC,NORTH AMERICA,2025-04-24,2,2,0,0,0
T&S,India,CONCENTRIX,APAC,2025-04-27,4,3,1,0,1
gCS,Brazil,ATENTO S.A.,LATAM,2025-04-29,3,5,0,0,0
gCS,India,REGALIX INC,APAC,2025-04-25,4,3,1,1,0
Geo,India,VIRTUSA CORPORATION,APAC,2025-04-24,2,1,1,1,0
Marketing,India,DELOITTE,APAC,2025-04-25,11,5,8,0,8
Technical Infrastructure,null,SCHENKER,NORTH AMERICA,2025-04-21,3,5,0,0,0
Ads & Commerce,India,TELEPERFORMANCE SE,APAC,2025-04-23,5,2,3,1,2
Ads & Commerce,India,TELEPERFORMANCE SE,APAC,2025-04-23,5,null,5,1,4
YouTube,Malaysia,CONCENTRIX,APAC,2025-04-24,5,1,4,0,4
Technical Infrastructure,United States,ALPHA SERVICES CORPORATION,NORTH AMERICA,2025-04-28,2,4,0,0,0
POps,United States,RED ARGYLE LLC,NORTH AMERICA,2025-04-25,11,1,10,0,10
gTech,India,GENPACT LIMITED,APAC,2025-04-21,4,6,0,0,0
T&S,India,ACCENTURE PLC,APAC,2025-04-21,6,3,5,0,5
gTech,India,COGNIZANT TECHNOLOGY SOLUTIONS CORPORATION,APAC,2025-04-23,2,2,0,0,0
Geo,India,ACCENTURE PLC,APAC,2025-04-21,9,1,8,1,7
Technical Infrastructure,United States,DIRECT LINE GLOBAL LLC,NORTH AMERICA,2025-04-28,6,4,4,3,1
Waymo,United States,TRANSDEV,NORTH AMERICA,2025-04-23,5,6,1,0,1
Cloud,India,HCL TECHNOLOGIES LTD,APAC,2025-04-21,1,3,0,0,0
Technical Infrastructure,United States,"HOLDER CONSTRUCTION GROUP, LLC",NORTH AMERICA,2025-04-25,1,1,0,0,0
YouTube,Portugal,COGNIZANT TECHNOLOGY SOLUTIONS CORPORATION,EMEA,2025-04-22,6,3,3,2,1
Platforms + Ecosystems,India,ITTIAM SYSTEMS PVT LTD,APAC,2025-04-29,7,5,4,0,4
gCS,India,WNS (HOLDINGS) LIMITED,APAC,2025-04-23,2,1,1,1,0
Technical Infrastructure,India,ERICSSON INC,APAC,2025-04-29,2,4,0,0,0
gTech,Colombia,CONCENTRIX,LATAM,2025-04-24,3,1,2,2,0
gTech,India,TECH MAHINDRA LIMITED,APAC,2025-04-23,2,1,1,1,0
YouTube,Ireland,ACCENTURE PLC,EMEA,2025-04-28,3,2,1,0,1
REWS,United States,EXOS,NORTH AMERICA,2025-04-25,2,2,0,0,0
Technical Infrastructure,United States,"HOLDER CONSTRUCTION GROUP, LLC",NORTH AMERICA,2025-05-02,3,3,0,0,0
Health,United States,"MEDAMERICA CONSULTING EMPLOYEES, INC.",NORTH AMERICA,2025-05-02,6,5,3,2,1
Cloud,null,EPAM SYSTEMS INC,EMEA,2025-05-01,3,3,0,0,0
Geo,India,WIPRO LIMITED,APAC,2025-04-23,2,2,0,0,0
Technical Infrastructure,null,THE WHITING TURNER CONTRACTING COMPANY,NORTH AMERICA,2025-04-25,3,3,0,0,0
Devices & Services,India,TECH MAHINDRA LIMITED,APAC,2025-04-29,11,2,9,8,1
Geo,India,COGNIZANT TECHNOLOGY SOLUTIONS CORPORATION,APAC,2025-05-01,5,5,2,2,0
YouTube,India,CONCENTRIX,APAC,2025-04-23,4,1,3,0,3
Technical Infrastructure,United States,A.G. KUNZ LLC,NORTH AMERICA,2025-04-30,5,2,3,0,3
Cloud,United States,DELOITTE,NORTH AMERICA,2025-04-22,3,4,1,1,0
T&S,India,WIPRO LIMITED,APAC,2025-04-25,6,4,4,0,4
Platforms + Ecosystems,United States,"EMBEDDED RESOURCE GROUP, INC.",NORTH AMERICA,2025-04-22,8,4,6,0,6
Technical Infrastructure,null,"ROONEY HOLDINGS, INC.",NORTH AMERICA,2025-05-02,3,3,0,0,0
Waymo,India,COGNIZANT TECHNOLOGY SOLUTIONS CORPORATION,APAC,2025-05-01,3,2,1,0,1
YouTube,India,ACCENTURE PLC,APAC,2025-04-21,6,3,5,1,4
Waymo,United States,"TASKUS, INC.",NORTH AMERICA,2025-05-02,3,3,0,0,0
Technical Infrastructure,United States,AMENTUM COMMERCIAL OPERATIONS INC,NORTH AMERICA,2025-04-24,8,3,5,1,4
Technical Infrastructure,United States,SCHENKER,NORTH AMERICA,2025-04-29,1,1,0,0,0
gCS,Philippines,CONCENTRIX,APAC,2025-04-30,2,2,0,0,0
Ads & Commerce,India,"APPLAUSE APP QUALITY, INC",APAC,2025-04-28,5,5,1,1,0
Technical Infrastructure,United States,TATA GROUP,NORTH AMERICA,2025-04-21,3,5,0,0,0
Technical Infrastructure,null,SCHENKER,NORTH AMERICA,2025-04-24,3,3,0,0,0
YouTube,India,CONCENTRIX,APAC,2025-04-21,3,2,1,1,0
Technical Infrastructure,United States,GXO LOGISTICS WORLDWIDE LLC,NORTH AMERICA,2025-04-28,4,3,1,0,1
Devices & Services,India,INFOSYS,APAC,2025-04-29,3,5,0,0,0
Platforms + Ecosystems,India,ITTIAM SYSTEMS PVT LTD,APAC,2025-04-28,6,5,3,0,3
Cloud,Philippines,HCL TECHNOLOGIES LTD,APAC,2025-04-30,10,2,8,0,8
T&S,India,WIPRO LIMITED,APAC,2025-04-30,3,4,1,0,1
Geo,India,COGNIZANT TECHNOLOGY SOLUTIONS CORPORATION,APAC,2025-04-30,4,5,1,1,0
Cloud,India,EXIMIETAS DESIGN LLC,APAC,2025-04-24,2,1,1,0,1
Technical Infrastructure,United States,SHIRLEY PARSONS PROFESSIONAL SERVICES LIMITED,NORTH AMERICA,2025-04-25,2,2,0,0,0
Global Affairs (w/o T&S),United States,VACO,NORTH AMERICA,2025-04-29,4,5,1,0,1
REWS,null,YARZIN SELLA MANAGEMENT AND HOLDINGS,EMEA,2025-04-24,3,3,0,0,0
YouTube,India,CONCENTRIX,APAC,2025-04-24,6,1,5,0,5
Technical Infrastructure,null,INDIGO TELECOM GROUP LTD,EMEA,2025-05-01,3,3,0,0,0
Technical Infrastructure,United States,ADECCO GROUP AG,NORTH AMERICA,2025-04-24,6,7,3,0,3
gTech,India,COGNIZANT TECHNOLOGY SOLUTIONS CORPORATION,APAC,2025-04-27,9,1,8,0,8
Waymo,India,WIPRO LIMITED,APAC,2025-04-30,2,1,1,1,0
T&S,Portugal,MAJOREL GLOBAL,EMEA,2025-04-29,6,2,4,3,1
Access,Poland,EPAM SYSTEMS INC,EMEA,2025-04-29,2,4,0,0,0
YouTube,India,CONCENTRIX,APAC,2025-04-21,3,2,1,0,1
Waymo,United States,METRO ONE LOSS PREVENTION SERVICES GROUP (GUARD DIVISION) INC,NORTH AMERICA,2025-04-21,7,5,4,0,4
POps,Taiwan,FAR EASTERN MEMORIAL HOSPITAL,APAC,2025-04-30,3,5,0,0,0
Technical Infrastructure,United States,GXO LOGISTICS WORLDWIDE LLC,NORTH AMERICA,2025-04-27,7,5,4,3,1
Technical Infrastructure,United States,GXO LOGISTICS WORLDWIDE LLC,NORTH AMERICA,2025-04-28,4,3,1,1,0
Technical Infrastructure,United States,C D MOODY CONSTRUCTION COMPANY INC,NORTH AMERICA,2025-04-24,3,3,0,0,0
Devices & Services,India,QUEST GLOBAL SERVICES PTE. LTD.,APAC,2025-04-22,4,6,0,0,0
Geo,India,WIPRO LIMITED,APAC,2025-04-25,2,2,0,0,0
YouTube,Romania,GENPACT LIMITED,EMEA,2025-04-22,8,6,4,1,3
Geo,India,ACCENTURE PLC,APAC,2025-04-25,13,1,12,1,11
gTech,Mexico,QUALITEST,LATAM,2025-04-30,7,3,4,0,4
Geo,Japan,COGNIZANT TECHNOLOGY SOLUTIONS CORPORATION,APAC,2025-04-24,3,1,2,0,2
Finance,India,LATENTVIEW ANALYTICS CORPORATION,APAC,2025-04-23,6,1,5,0,5
REWS,India,JONES LANG LASALLE INC,APAC,2025-04-25,3,3,0,0,0
T&S,India,WIPRO LIMITED,APAC,2025-04-23,4,4,2,0,2
gTech,India,VIRTUSA CORPORATION,APAC,2025-04-25,3,2,1,0,1
Geo,India,WIPRO LIMITED,APAC,2025-04-27,5,1,4,3,1
gTech,India,COGNIZANT TECHNOLOGY SOLUTIONS CORPORATION,APAC,2025-05-01,4,4,2,2,0
T&S,India,ACCENTURE PLC,APAC,2025-05-02,8,2,6,4,2
Marketing,United States,TELLAGENCE INC,NORTH AMERICA,2025-04-29,7,5,4,1,3
Technical Infrastructure,Ireland,TURNER & TOWNSEND PARTNERS LLP,EMEA,2025-04-24,5,4,3,0,3
Waymo,India,WIPRO LIMITED,APAC,2025-04-30,2,1,1,1,0
gCS,China,ACCENTURE PLC,APAC,2025-04-27,3,1,2,0,2
Geo,India,WIPRO LIMITED,APAC,2025-04-27,3,2,1,0,1
REWS,India,COMPASS GROUP PLC,APAC,2025-04-21,3,5,0,0,0
Technical Infrastructure,United States,TURNER & TOWNSEND PARTNERS LLP,NORTH AMERICA,2025-04-29,5,2,3,0,3
REWS,United States,MC DEAN INC,NORTH AMERICA,2025-04-23,2,1,1,0,1
REWS,India,JAGUAR SECURITY SERVICES PVT. LTD.,APAC,2025-05-01,7,3,4,1,3
Marketing,Canada,DELOITTE,NORTH AMERICA,2025-05-02,4,2,2,0,2
REWS,null,JONES LANG LASALLE INC,APAC,2025-05-02,3,3,0,0,0
Platforms + Ecosystems,India,HCL TECHNOLOGIES LTD,APAC,2025-04-30,5,5,2,0,2
gCS,India,WNS (HOLDINGS) LIMITED,APAC,2025-04-24,3,1,2,1,1
Technical Infrastructure,United States,ALLIED UNIVERSAL,NORTH AMERICA,2025-04-27,4,3,1,0,1
REWS,United States,CBRE GROUP INC,NORTH AMERICA,2025-05-02,5,4,3,2,1
Access,United States,IBEX HOLDINGS LIMITED,NORTH AMERICA,2025-04-22,3,4,1,0,1
REWS,India,COMPASS GROUP PLC,APAC,2025-04-25,2,2,0,0,0
gCS,India,ACCENTURE PLC,APAC,2025-04-25,14,1,13,5,8
Corp Eng,India,VIRTUSA CORPORATION,APAC,2025-04-28,6,4,4,0,4
T&S,India,WIPRO LIMITED,APAC,2025-04-28,3,5,0,0,0
Technical Infrastructure,Thailand,JONES LANG LASALLE INC,APAC,2025-04-24,11,1,10,10,0
Technical Infrastructure,null,SCHENKER,NORTH AMERICA,2025-04-21,3,5,0,0,0
gCS,India,REGALIX INC,APAC,2025-04-24,3,2,1,0,1
Cloud,India,COGNIZANT TECHNOLOGY SOLUTIONS CORPORATION,APAC,2025-04-23,4,5,1,1,0
T&S,India,OPTIMUM INFOSYSTEMS PVT. LTD.,APAC,2025-04-21,4,10,0,0,0
Access,United States,DYCOM INDUSTRIES,NORTH AMERICA,2025-04-22,3,4,1,0,1
Technical Infrastructure,Finland,FIBER HIGHWAY FINLAND OY,EMEA,2025-04-28,2,4,0,0,0
Finance,India,PWC,APAC,2025-04-21,3,2,1,1,0
YouTube,Ireland,ACCENTURE PLC,EMEA,2025-04-28,3,2,1,0,1
Technical Infrastructure,Philippines,ASTREYA PARTNERS INC,APAC,2025-04-25,2,1,1,1,0
REWS,Singapore,COMPASS GROUP PLC,APAC,2025-04-21,2,1,1,0,1
REWS,United States,ISS A/S,NORTH AMERICA,2025-04-24,2,2,0,0,0
Devices & Services,United States,ARCHLYNK LLC,NORTH AMERICA,2025-05-02,5,4,3,2,1
gTech,India,COGNIZANT TECHNOLOGY SOLUTIONS CORPORATION,APAC,2025-04-24,3,1,2,1,1
Global Affairs (w/o T&S),United States,AXIOM GLOBAL INC,NORTH AMERICA,2025-05-02,5,3,4,0,4
Technical Infrastructure,null,"ROONEY HOLDINGS, INC.",NORTH AMERICA,2025-05-01,3,3,0,0,0
Technical Infrastructure,United Kingdom,GLEAVE PARTNERSHIP LIMITED,EMEA,2025-04-25,7,2,5,5,0
Technical Infrastructure,United States,ACCENTURE PLC,NORTH AMERICA,2025-05-01,7,2,5,0,5
REWS,India,JONES LANG LASALLE INC,APAC,2025-04-21,4,6,0,0,0
GBO (w/o gTech & gCS),Philippines,ACCENTURE PLC,APAC,2025-05-02,4,2,2,0,2
gTech,India,TELEPERFORMANCE SE,APAC,2025-04-28,5,3,2,0,2
Devices & Services,United States,WIPRO LIMITED,NORTH AMERICA,2025-04-22,2,4,0,0,0
Technical Infrastructure,India,HT GLOBAL IT SOLUTIONS HOLDINGS LIMITED,APAC,2025-04-21,8,6,4,0,4
Technical Infrastructure,United States,TURNER & TOWNSEND PARTNERS LLP,NORTH AMERICA,2025-04-25,3,2,1,0,1
Technical Infrastructure,United States,SCHENKER,NORTH AMERICA,2025-05-02,6,5,3,2,1
DeepMind,United States,SCALE AI INC,NORTH AMERICA,2025-04-21,21,5,18,9,9
Cloud,India,ACCENTURE PLC,APAC,2025-05-02,3,3,0,0,0
Technical Infrastructure,null,CERTIFIED MAINTENANCE SERVICE INC.,NORTH AMERICA,2025-05-01,3,3,0,0,0
Geo,India,WIPRO LIMITED,APAC,2025-04-27,2,1,1,0,1
Technical Infrastructure,United States,SCHENKER,NORTH AMERICA,2025-04-24,3,3,0,0,0
Devices & Services,India,INFOSYS,APAC,2025-04-27,9,1,8,0,8
Waymo,India,WIPRO LIMITED,APAC,2025-04-27,4,1,3,0,3
T&S,India,COGNIZANT TECHNOLOGY SOLUTIONS CORPORATION,APAC,2025-04-23,2,1,1,0,1
gTech,India,VIRTUSA CORPORATION,APAC,2025-04-25,3,2,1,1,0
gTech,Mexico,ACCENTURE PLC,LATAM,2025-04-23,6,3,3,3,0
Waymo,United States,TRANSDEV,NORTH AMERICA,2025-04-23,6,6,2,0,2
Ads & Commerce,Poland,TELUS,EMEA,2025-04-30,4,5,1,0,1
T&S,India,WIPRO LIMITED,APAC,2025-04-30,5,2,3,1,2
Technical Infrastructure,United Kingdom,SYNERGY SECURITY SOLUTIONS LIMITED,EMEA,2025-05-01,7,2,5,2,3
Cloud,United States,TECH MAHINDRA LIMITED,NORTH AMERICA,2025-04-25,5,6,1,0,1
REWS,null,SODEXO,APAC,2025-05-02,3,3,0,0,0
REWS,null,LUX BUS AMERICA CO,NORTH AMERICA,2025-04-22,3,5,0,0,0
Finance,United States,ERNST AND YOUNG LLP,NORTH AMERICA,2025-04-30,6,3,3,3,0
REWS,Finland,CBRE GROUP INC,EMEA,2025-05-02,3,3,0,0,0
gTech,India,VACO,APAC,2025-04-25,3,1,2,0,2
Waymo,United States,TRANSDEV,NORTH AMERICA,2025-04-24,7,3,4,1,3
T&S,India,WIPRO LIMITED,APAC,2025-04-25,2,2,0,0,0
POps,India,RANDSTAD NV,APAC,2025-05-02,7,1,6,0,6
YouTube,United States,"ARTECH INFORMATION SYSTEMS, LLC",NORTH AMERICA,2025-04-22,25,12,20,18,2
REWS,India,JONES LANG LASALLE INC,APAC,2025-04-22,1,1,0,0,0
Finance,Poland,DELOITTE,EMEA,2025-04-23,8,3,7,6,1
POps,India,RANDSTAD NV,APAC,2025-05-01,15,5,12,5,7
gTech,India,TECH MAHINDRA LIMITED,APAC,2025-04-27,3,2,1,1,0
Finance,Ireland,PWC,EMEA,2025-04-23,6,3,3,2,1
Technical Infrastructure,Germany,SOBEN GROUP HOLDINGS LTD,EMEA,2025-04-29,1,1,1,1,0
YouTube,India,CONCENTRIX,APAC,2025-04-30,4,6,0,0,0
gTech,Philippines,TELUS,APAC,2025-04-28,6,4,4,4,0
Ads & Commerce,India,FRACTAL ANALYTICS PRIVATE LIMITED,APAC,2025-04-23,4,5,1,0,1
Platforms + Ecosystems,India,HCL TECHNOLOGIES LTD,APAC,2025-04-29,4,5,1,0,1
Technical Infrastructure,United States,THE WHITING TURNER CONTRACTING COMPANY,NORTH AMERICA,2025-04-22,3,5,0,0,0
YouTube,India,CONCENTRIX,APAC,2025-04-23,3,4,1,0,1
T&S,India,WIPRO LIMITED,APAC,2025-04-25,2,5,0,0,0
Finance,United States,PWC,NORTH AMERICA,2025-04-22,5,1,4,2,2
Technical Infrastructure,Netherlands,SECURITAS AB,EMEA,2025-04-29,5,1,4,3,1
YouTube,India,ACCENTURE PLC,APAC,2025-05-02,6,4,4,3,1
Geo,India,COGNIZANT TECHNOLOGY SOLUTIONS CORPORATION,APAC,2025-05-01,5,5,2,2,0
Technical Infrastructure,United States,CERTIFIED MAINTENANCE SERVICE INC.,NORTH AMERICA,2025-04-22,4,6,0,0,0
POps,India,RANDSTAD NV,APAC,2025-04-24,7,1,6,1,5
Technical Infrastructure,United States,GXO LOGISTICS WORLDWIDE LLC,NORTH AMERICA,2025-04-21,4,2,2,1,1
Devices & Services,India,INFOSYS,APAC,2025-04-23,6,1,5,1,4
REWS,India,COMPASS GROUP PLC,APAC,2025-04-24,2,1,1,1,0
gTech,India,TELEPERFORMANCE SE,APAC,2025-04-22,5,1,4,1,3
gTech,India,TELEPERFORMANCE SE,APAC,2025-04-22,5,1,4,2,2
Technical Infrastructure,null,SCHENKER,NORTH AMERICA,2025-04-25,6,8,0,0,0
POps,India,RANDSTAD NV,APAC,2025-05-02,7,1,6,0,6
YouTube,United States,TELEPERFORMANCE SE,NORTH AMERICA,2025-04-30,5,5,2,2,0
Geo,India,ACCENTURE PLC,APAC,2025-04-24,3,1,2,2,0
Waymo,India,COGNIZANT TECHNOLOGY SOLUTIONS CORPORATION,APAC,2025-04-23,3,4,1,1,0
POps,United States,GALAXY US OPCO INC. DBA VIALTO PARTNERS,NORTH AMERICA,2025-04-29,14,1,13,0,13
Waymo,India,COGNIZANT TECHNOLOGY SOLUTIONS CORPORATION,APAC,2025-04-24,2,1,1,0,1
Ads & Commerce,India,TELEPERFORMANCE SE,APAC,2025-04-27,8,null,8,8,0
YouTube,India,COGNIZANT TECHNOLOGY SOLUTIONS CORPORATION,APAC,2025-04-21,2,1,1,1,0
gTech,India,VIRTUSA CORPORATION,APAC,2025-04-27,4,3,1,0,1
Cloud,India,ALTRAN GROUP,APAC,2025-04-25,4,1,3,0,3
Cloud,United States,GLOBALLOGIC INC,NORTH AMERICA,2025-04-29,11,1,10,10,0
Cloud,Philippines,HCL TECHNOLOGIES LTD,APAC,2025-05-02,12,2,10,0,10
YouTube,Portugal,COGNIZANT TECHNOLOGY SOLUTIONS CORPORATION,EMEA,2025-04-22,6,2,4,3,1
Access,United States,"MAGNIT, LLC",NORTH AMERICA,2025-04-28,5,12,3,0,3
REWS,France,CBRE GROUP INC,EMEA,2025-04-22,5,7,0,0,0
gTech,Poland,TELEPERFORMANCE SE,EMEA,2025-04-28,3,5,0,0,0
YouTube,India,ACCENTURE PLC,APAC,2025-04-21,6,4,4,0,4
Technical Infrastructure,United States,MCFARLAND BUILDING GROUP LLC,NORTH AMERICA,2025-04-24,3,3,0,0,0
T&S,India,WIPRO LIMITED,APAC,2025-04-25,4,3,1,0,1
Corp Eng,India,VIRTUSA CORPORATION,APAC,2025-04-28,6,4,4,0,4
Corp Eng,India,ACCENTURE PLC,APAC,2025-04-24,5,1,4,1,3
gTech,India,COGNIZANT TECHNOLOGY SOLUTIONS CORPORATION,APAC,2025-04-25,3,2,1,0,1
Technical Infrastructure,null,"HOLDER CONSTRUCTION GROUP, LLC",NORTH AMERICA,2025-04-21,3,5,0,0,0
Marketing,India,LATENTVIEW ANALYTICS CORPORATION,APAC,2025-04-21,2,1,1,1,0
gCS,Brazil,TTEC HOLDINGS INC,LATAM,2025-04-28,11,5,8,7,1
Geo,Brazil,COGNIZANT TECHNOLOGY SOLUTIONS CORPORATION,LATAM,2025-04-22,3,1,2,0,2
T&S,Poland,ACCENTURE PLC,EMEA,2025-04-23,7,3,4,3,1
Technical Infrastructure,null,SATURN PARTNERS LLC,NORTH AMERICA,2025-04-24,3,3,0,0,0
YouTube,India,ACCENTURE PLC,APAC,2025-04-24,5,4,3,3,0
T&S,India,COGNIZANT TECHNOLOGY SOLUTIONS CORPORATION,APAC,2025-04-25,4,1,3,3,0
Technical Infrastructure,United States,"HOLDER CONSTRUCTION GROUP, LLC",NORTH AMERICA,2025-04-30,2,2,0,0,0
Cloud,United States,GENERAL DYNAMICS INFORMATION TECHNOLOGY,NORTH AMERICA,2025-04-23,6,3,3,2,1
YouTube,India,ACCENTURE PLC,APAC,2025-04-23,4,4,2,0,2
YouTube,India,TATA GROUP,APAC,2025-04-29,3,4,1,1,0
Waymo,United States,ABM INDUSTRIES INCORPORATED,NORTH AMERICA,2025-04-28,2,4,0,0,0
REWS,United States,DELOITTE,NORTH AMERICA,2025-04-29,5,1,4,2,2
Finance,Philippines,ACCENTURE PLC,APAC,2025-04-21,2,1,1,0,1
Technical Infrastructure,United States,VISION TECHNOLOGIES INC.,NORTH AMERICA,2025-04-25,3,1,2,2,0
YouTube,India,ACCENTURE PLC,APAC,2025-04-22,7,4,5,1,4
YouTube,India,CONCENTRIX,APAC,2025-04-21,3,2,1,1,0
Access,United States,INSIGHT,NORTH AMERICA,2025-04-24,8,3,5,0,5
Technical Infrastructure,United States,GARDA WORLD SECURITY CORPORATION,NORTH AMERICA,2025-04-21,5,3,2,0,2
Global Affairs (w/o T&S),United States,"CONSILIO, INC",NORTH AMERICA,2025-04-29,8,4,6,0,6
Corp Eng,India,CHARCOALBLUE LLP,APAC,2025-04-28,8,6,4,3,1
T&S,India,WIPRO LIMITED,APAC,2025-04-30,5,2,3,1,2
GBO (w/o gTech & gCS),Philippines,ACCENTURE PLC,APAC,2025-04-25,9,1,8,0,8
Platforms + Ecosystems,Philippines,NCC GROUP,APAC,2025-05-02,4,3,1,1,0
Cloud,India,CLOUDSUFI INC.,APAC,2025-04-21,5,3,2,0,2
YouTube,India,TECH MAHINDRA LIMITED,APAC,2025-04-24,2,1,1,0,1
gCS,India,REGALIX INC,APAC,2025-04-23,5,5,2,2,0
REWS,Taiwan,"LIANG PIN DINING CO., LTD.",APAC,2025-05-02,3,3,0,0,0
DeepMind,United States,SCALE AI INC,NORTH AMERICA,2025-04-21,18,1,17,0,17
Cloud,United States,ONIX NETWORKING CORP.,NORTH AMERICA,2025-05-02,5,4,3,1,2
Technical Infrastructure,Malaysia,SHIRLEY PARSONS PROFESSIONAL SERVICES LIMITED,APAC,2025-04-30,5,5,2,1,1
Waymo,India,COGNIZANT TECHNOLOGY SOLUTIONS CORPORATION,APAC,2025-04-23,1,1,0,0,0
DeepMind,United States,SCALE AI INC,NORTH AMERICA,2025-04-21,16,4,14,0,14
Geo,India,WIPRO LIMITED,APAC,2025-04-23,2,1,1,1,0
T&S,India,ACCENTURE PLC,APAC,2025-04-25,4,3,1,0,1
gTech,Portugal,COGNIZANT TECHNOLOGY SOLUTIONS CORPORATION,EMEA,2025-04-22,6,1,5,4,1
YouTube,India,ACCENTURE PLC,APAC,2025-05-02,6,5,3,0,3
T&S,Malaysia,ACCENTURE PLC,APAC,2025-04-28,4,1,3,0,3
gCS,India,TELEDIRECT PTE LTD,APAC,2025-04-23,7,3,4,4,0
Waymo,United States,TRANSDEV,NORTH AMERICA,2025-04-25,8,1,7,3,4
Waymo,India,WIPRO LIMITED,APAC,2025-04-30,2,2,0,0,0
Technical Infrastructure,null,ALPHA SERVICES CORPORATION,NORTH AMERICA,2025-04-29,3,5,0,0,0
Finance,United States,PWC,NORTH AMERICA,2025-04-22,15,1,14,2,12
REWS,Switzerland,COMPASS GROUP PLC,EMEA,2025-04-23,1,1,0,0,0
gTech,India,COGNIZANT TECHNOLOGY SOLUTIONS CORPORATION,APAC,2025-04-23,5,2,3,1,2
REWS,United States,JONES LANG LASALLE INC,NORTH AMERICA,2025-04-30,3,5,0,0,0
Technical Infrastructure,India,IRON SYSTEMS INC,APAC,2025-04-29,10,3,7,0,7
Ads & Commerce,India,TELEPERFORMANCE SE,APAC,2025-04-29,9,1,8,8,0
Geo,India,COGNIZANT TECHNOLOGY SOLUTIONS CORPORATION,APAC,2025-04-28,3,2,1,0,1
REWS,null,JONES LANG LASALLE INC,NORTH AMERICA,2025-04-30,3,5,0,0,0
Devices & Services,United States,ARCHLYNK LLC,NORTH AMERICA,2025-04-28,19,1,18,18,0
POps,India,RANDSTAD NV,APAC,2025-05-02,7,1,6,6,0
REWS,India,JONES LANG LASALLE INC,APAC,2025-04-25,3,3,0,0,0
Waymo,United States,TRANSDEV,NORTH AMERICA,2025-04-24,7,2,5,3,2
Technical Infrastructure,United States,"CBM OF AMERICA, INC. (VENDOR)",NORTH AMERICA,2025-05-02,3,3,0,0,0
GBO (w/o gTech & gCS),Poland,TTEC HOLDINGS INC,EMEA,2025-04-25,2,2,0,0,0
Technical Infrastructure,United States,GARDA WORLD SECURITY CORPORATION,NORTH AMERICA,2025-04-30,2,2,0,0,0
Technical Infrastructure,Thailand,WOOD INTERNATIONAL LIMITED,APAC,2025-04-29,4,1,3,0,3
T&S,India,CONCENTRIX,APAC,2025-04-21,3,1,2,2,0
YouTube,United States,TELEPERFORMANCE SE,NORTH AMERICA,2025-04-30,5,6,1,1,0
gTech,India,VIRTUSA CORPORATION,APAC,2025-04-23,6,3,3,0,3
T&S,Philippines,ACCENTURE PLC,APAC,2025-04-21,5,2,3,0,3
Waymo,India,WIPRO LIMITED,APAC,2025-04-30,6,1,5,5,0
Cloud,India,HCL TECHNOLOGIES LTD,APAC,2025-04-23,2,2,0,0,0
Platforms + Ecosystems,India,ITTIAM SYSTEMS PVT LTD,APAC,2025-04-28,2,1,1,0,1
YouTube,India,CONCENTRIX,APAC,2025-04-30,2,2,0,0,0
gTech,India,VIRTUSA CORPORATION,APAC,2025-04-21,4,3,1,0,1
REWS,China,SODEXO,APAC,2025-04-22,1,1,0,0,0
REWS,null,JONES LANG LASALLE INC,NORTH AMERICA,2025-04-23,3,5,0,0,0
REWS,United States,PROPARK AMERICA WEST LLC,NORTH AMERICA,2025-04-28,2,4,0,0,0
gTech,Greece,TELEPERFORMANCE SE,EMEA,2025-04-30,5,5,2,0,2
YouTube,India,CONCENTRIX,APAC,2025-04-21,3,1,2,0,2
Technical Infrastructure,United States,GXO LOGISTICS WORLDWIDE LLC,NORTH AMERICA,2025-04-21,4,2,2,1,1
gTech,India,TELEPERFORMANCE SE,APAC,2025-04-24,8,3,5,5,0
Corp Eng,United States,DELOITTE,NORTH AMERICA,2025-04-23,1,1,0,0,0
POps,United States,ACCENTURE PLC,NORTH AMERICA,2025-04-22,9,5,6,6,0
Cloud,India,INFOSYS,APAC,2025-04-22,12,4,10,0,10
Global Affairs (w/o T&S),United States,"CONSILIO, INC",NORTH AMERICA,2025-04-25,5,4,3,0,3
Cloud,India,CAPGEMINI SE,APAC,2025-04-21,3,5,0,0,0
REWS,United States,COMPASS GROUP PLC,NORTH AMERICA,2025-05-01,3,3,0,0,0
REWS,India,FLUXON APPS LLC,APAC,2025-04-25,9,2,7,5,2
YouTube,India,ACCENTURE PLC,APAC,2025-04-24,5,1,4,0,4
REWS,Germany,PUETZ SECURITY AG,EMEA,2025-04-25,3,1,2,1,1
Access,United States,IBEX HOLDINGS LIMITED,NORTH AMERICA,2025-04-22,3,1,2,0,2
POps,null,FOUNDING YEARS LEARNNG SOLUTIONS PVT LTD,APAC,2025-04-28,3,5,0,0,0
Technical Infrastructure,United States,J E DUNN CONSTRUCTION COMPANY,NORTH AMERICA,2025-04-28,1,3,0,0,0
gTech,Mexico,QUALITEST,LATAM,2025-04-21,5,2,3,0,3
REWS,India,JONES LANG LASALLE INC,APAC,2025-04-23,1,1,0,0,0
gTech,Portugal,QUALITEST,EMEA,2025-04-29,5,6,1,1,0
Cloud,El Salvador,TELUS,LATAM,2025-04-30,2,2,0,0,0
Cloud,India,COGNIZANT TECHNOLOGY SOLUTIONS CORPORATION,APAC,2025-05-01,5,4,3,0,3
YouTube,India,WIPRO LIMITED,APAC,2025-04-21,5,2,4,2,2
Platforms + Ecosystems,India,INFOSYS,APAC,2025-04-28,9,1,8,1,7
gCS,Philippines,CONCENTRIX,APAC,2025-04-30,2,2,0,0,0
Corp Eng,India,MOVATE TECHNOLOGIES PRIVATE LIMITED,APAC,2025-04-23,6,7,1,0,1
gTech,India,TECH MAHINDRA LIMITED,APAC,2025-04-22,1,1,0,0,0
T&S,India,WIPRO LIMITED,APAC,2025-04-28,4,1,3,0,3
T&S,Malaysia,ACCENTURE PLC,APAC,2025-04-24,5,7,0,0,0
gTech,India,COGNIZANT TECHNOLOGY SOLUTIONS CORPORATION,APAC,2025-05-02,4,3,1,0,1
REWS,India,FLUXON APPS LLC,APAC,2025-04-22,6,3,3,2,1
Technical Infrastructure,United States,GARDA WORLD SECURITY CORPORATION,NORTH AMERICA,2025-05-01,3,2,1,1,0
REWS,India,JONES LANG LASALLE INC,APAC,2025-04-21,2,4,0,0,0
Technical Infrastructure,null,ARRIS SOLUTIONS INC,EMEA,2025-04-28,3,5,0,0,0
REWS,United States,ALLIED UNIVERSAL,NORTH AMERICA,2025-04-25,3,1,2,0,2
POps,India,RANDSTAD NV,APAC,2025-04-25,11,1,10,1,9
Technical Infrastructure,United States,TW CONSTRUCTORS LLC,NORTH AMERICA,2025-04-28,7,11,0,0,0
REWS,India,JONES LANG LASALLE INC,APAC,2025-04-22,1,1,0,0,0
gTech,Portugal,COGNIZANT TECHNOLOGY SOLUTIONS CORPORATION,EMEA,2025-04-22,6,1,5,4,1
gTech,Japan,ACCENTURE PLC,APAC,2025-04-22,7,5,4,0,4
Cloud,Spain,WEBHELP GROUP,EMEA,2025-04-29,4,1,3,0,3
Technical Infrastructure,United States,J E DUNN CONSTRUCTION COMPANY,NORTH AMERICA,2025-04-22,3,5,0,0,0
T&S,India,WIPRO LIMITED,APAC,2025-04-21,6,3,5,0,5
gTech,India,COGNIZANT TECHNOLOGY SOLUTIONS CORPORATION,APAC,2025-04-29,4,5,1,1,0
Cloud,India,INFOSYS,APAC,2025-05-02,8,6,4,0,4
REWS,Finland,COMPASS GROUP PLC,EMEA,2025-04-30,3,5,0,0,0
Technical Infrastructure,United States,ALLIED UNIVERSAL,NORTH AMERICA,2025-04-23,8,4,6,6,0
Corp Eng,India,MOVATE TECHNOLOGIES PRIVATE LIMITED,APAC,2025-04-25,4,2,2,0,2
REWS,null,SODEXO,NORTH AMERICA,2025-04-29,4,6,0,0,0
Technical Infrastructure,United States,TW CONSTRUCTORS LLC,NORTH AMERICA,2025-04-24,1,1,0,0,0
Cloud,India,COGNIZANT TECHNOLOGY SOLUTIONS CORPORATION,APAC,2025-04-21,1,3,0,0,0
Technical Infrastructure,United States,DIRECT LINE GLOBAL LLC,NORTH AMERICA,2025-04-22,2,3,1,1,0
Waymo,United States,TRANSDEV,NORTH AMERICA,2025-04-25,8,3,5,1,4
Technical Infrastructure,United States,SCHENKER,NORTH AMERICA,2025-04-23,2,2,0,0,0
T&S,Malaysia,ACCENTURE PLC,APAC,2025-04-22,5,3,2,0,2
T&S,India,WIPRO LIMITED,APAC,2025-04-25,2,5,0,0,0
Devices & Services,India,TECH MAHINDRA LIMITED,APAC,2025-04-27,12,5,9,0,9
REWS,null,G4S PLC,LATAM,2025-04-25,3,3,0,0,0
REWS,United States,GARDA WORLD SECURITY CORPORATION,NORTH AMERICA,2025-04-21,10,4,7,6,1
Devices & Services,United States,LOGISTICS PLUS INC.,NORTH AMERICA,2025-04-30,6,3,3,0,3
YouTube,Romania,GENPACT LIMITED,EMEA,2025-04-23,1,1,0,0,0
Corp Eng,null,CONCENTRIX,EMEA,2025-04-21,3,5,0,0,0
T&S,India,WIPRO LIMITED,APAC,2025-04-23,13,6,9,8,1
Waymo,India,WIPRO LIMITED,APAC,2025-05-01,3,2,1,1,0
Technical Infrastructure,Germany,SCHENKER,EMEA,2025-04-28,18,6,14,0,14
Cloud,United States,MARKETSTAR CORPORATION,NORTH AMERICA,2025-04-21,2,1,1,0,1
gTech,India,COGNIZANT TECHNOLOGY SOLUTIONS CORPORATION,APAC,2025-04-27,4,2,2,1,1
gTech,Mexico,QUALITEST,LATAM,2025-05-01,8,7,3,3,0
Corp Eng,India,ASTREYA PARTNERS INC,APAC,2025-04-25,8,3,5,0,5
Technical Infrastructure,United States,C D MOODY CONSTRUCTION COMPANY INC,NORTH AMERICA,2025-04-24,3,3,0,0,0
YouTube,India,ACCENTURE PLC,APAC,2025-04-21,6,4,4,0,4
Technical Infrastructure,United States,GXO LOGISTICS WORLDWIDE LLC,NORTH AMERICA,2025-04-24,2,2,0,0,0
gTech,India,TELEPERFORMANCE SE,APAC,2025-04-21,4,1,3,1,2
Waymo,United States,"MAGNIT, LLC",NORTH AMERICA,2025-04-28,12,12,10,10,0
YouTube,Portugal,COGNIZANT TECHNOLOGY SOLUTIONS CORPORATION,EMEA,2025-04-22,6,4,2,1,1
REWS,null,SODEXO,APAC,2025-05-02,3,3,0,0,0
REWS,India,JONES LANG LASALLE INC,APAC,2025-04-22,1,1,0,0,0
Technical Infrastructure,null,"HOLDER CONSTRUCTION GROUP, LLC",NORTH AMERICA,2025-04-23,3,5,0,0,0
Finance,Philippines,ACCENTURE PLC,APAC,2025-05-01,5,5,2,1,1
Waymo,United States,"TASKUS, INC.",NORTH AMERICA,2025-05-02,4,2,2,1,1
Corp Eng,null,SIGNIFI SOLUTIONS INC.,NORTH AMERICA,2025-04-22,3,5,0,0,0
gTech,India,COGNIZANT TECHNOLOGY SOLUTIONS CORPORATION,APAC,2025-04-21,2,1,1,1,0
Devices & Services,India,QUEST GLOBAL SERVICES PTE. LTD.,APAC,2025-04-22,4,6,0,0,0
gTech,India,COGNIZANT TECHNOLOGY SOLUTIONS CORPORATION,APAC,2025-04-23,2,2,0,0,0
POps,India,ACCENTURE PLC,APAC,2025-04-29,4,2,2,1,1
YouTube,India,TELEPERFORMANCE SE,APAC,2025-04-21,3,5,0,0,0
T&S,Poland,ACCENTURE PLC,EMEA,2025-04-22,8,5,5,3,2
T&S,Philippines,ACCENTURE PLC,APAC,2025-05-02,7,2,5,0,5
YouTube,India,GENPACT LIMITED,APAC,2025-04-22,2,3,1,1,0
gTech,India,TELEPERFORMANCE SE,APAC,2025-04-21,4,1,3,1,2
T&S,India,COGNIZANT TECHNOLOGY SOLUTIONS CORPORATION,APAC,2025-04-23,2,1,1,0,1
REWS,India,SODEXO,APAC,2025-04-22,1,1,0,0,0
Technical Infrastructure,United States,ALLIED UNIVERSAL,NORTH AMERICA,2025-05-02,3,3,0,0,0
POps,United States,"MAGNIT, LLC",NORTH AMERICA,2025-04-27,3,6,0,0,0
T&S,India,WIPRO LIMITED,APAC,2025-04-28,4,1,3,0,3
gTech,India,VIRTUSA CORPORATION,APAC,2025-04-25,3,3,0,0,0
Technical Infrastructure,United States,GXO LOGISTICS WORLDWIDE LLC,NORTH AMERICA,2025-04-25,12,5,9,5,4
gTech,India,TELEPERFORMANCE SE,APAC,2025-04-21,3,1,2,2,0
POps,Taiwan,DELOITTE,APAC,2025-04-29,3,5,0,0,0
Technical Infrastructure,United States,SCHENKER,NORTH AMERICA,2025-04-28,3,5,0,0,0
REWS,United States,CBRE GROUP INC,NORTH AMERICA,2025-04-24,6,6,2,1,1
Platforms + Ecosystems,United States,SCALENCE LLC,NORTH AMERICA,2025-04-30,5,2,3,2,1
Waymo,India,WIPRO LIMITED,APAC,2025-04-24,3,4,0,0,0
REWS,United States,JAMESTOWN L.P.,NORTH AMERICA,2025-04-28,12,5,9,2,7
Technical Infrastructure,India,TRACE3 INC,APAC,2025-04-28,2,1,1,1,0
Devices & Services,Taiwan,TESSOLVE SEMICONDUCTOR PVT LTD,APAC,2025-04-28,3,5,0,0,0
gTech,India,GENPACT LIMITED,APAC,2025-04-22,4,6,0,0,0
gTech,Portugal,COGNIZANT TECHNOLOGY SOLUTIONS CORPORATION,EMEA,2025-04-23,7,3,4,3,1
Waymo,Philippines,COGNIZANT TECHNOLOGY SOLUTIONS CORPORATION,APAC,2025-04-22,6,2,4,4,0
Technical Infrastructure,United States,GXO LOGISTICS WORLDWIDE LLC,NORTH AMERICA,2025-04-24,2,2,0,0,0
Technical Infrastructure,null,INDIGO TELECOM GROUP LTD,LATAM,2025-05-01,3,3,0,0,0
gCS,China,ACCENTURE PLC,APAC,2025-04-24,10,6,6,0,6
T&S,India,WIPRO LIMITED,APAC,2025-04-30,5,2,3,1,2
Access,United States,IBEX HOLDINGS LIMITED,NORTH AMERICA,2025-04-22,3,1,2,0,2
Corp Eng,India,HCL TECHNOLOGIES LTD,APAC,2025-04-22,4,1,3,1,2
REWS,India,JONES LANG LASALLE INC,APAC,2025-05-02,3,3,0,0,0
Corp Eng,India,VIRTUSA CORPORATION,APAC,2025-04-24,2,1,1,0,1
Access,India,WIPRO LIMITED,APAC,2025-04-30,3,5,0,0,0
POps,India,RANDSTAD NV,APAC,2025-04-25,11,1,10,0,10
Waymo,India,WIPRO LIMITED,APAC,2025-04-24,3,4,0,0,0
Marketing,United States,CONTINUUMGLOBAL INC,NORTH AMERICA,2025-04-24,6,2,4,2,2
YouTube,India,CONCENTRIX,APAC,2025-04-21,3,2,1,0,1
Cloud,Greece,TELEPERFORMANCE SE,EMEA,2025-04-29,3,5,0,0,0
REWS,India,SODEXO,APAC,2025-05-02,3,3,0,0,0
POps,India,ACCENTURE PLC,APAC,2025-04-30,3,4,1,0,1
REWS,null,COMPASS GROUP PLC,APAC,2025-04-21,3,5,0,0,0
REWS,India,SIMPLIWORK OFFICES PRIVATE LIMITED,APAC,2025-04-22,1,1,0,0,0
REWS,India,JONES LANG LASALLE INC,APAC,2025-04-23,1,1,0,0,0
REWS,United States,SODEXO,NORTH AMERICA,2025-04-24,1,1,0,0,0
gCS,India,REGALIX INC,APAC,2025-04-25,4,3,1,1,0
Devices & Services,India,QUEST GLOBAL SERVICES PTE. LTD.,APAC,2025-04-22,4,6,0,0,0
Cloud,India,PERSISTENT SYSTEMS LIMITED,APAC,2025-04-24,12,3,9,4,5
Technical Infrastructure,United States,SCHENKER,NORTH AMERICA,2025-04-25,4,4,0,0,0
Cloud,Mexico,TATA GROUP,LATAM,2025-04-21,4,3,1,0,1
Technical Infrastructure,United States,ADECCO GROUP AG,NORTH AMERICA,2025-05-01,6,10,3,0,3
Access,United States,"INFRASTRUCTURE TECHNOLOGY SERVICES, INC.",NORTH AMERICA,2025-04-29,30,3,27,26,1
Waymo,Philippines,COGNIZANT TECHNOLOGY SOLUTIONS CORPORATION,APAC,2025-05-02,4,2,2,1,1
Technical Infrastructure,United States,ALLIED UNIVERSAL,NORTH AMERICA,2025-04-21,2,1,1,0,1
Technical Infrastructure,United States,GARDA WORLD SECURITY CORPORATION,NORTH AMERICA,2025-05-02,4,3,1,0,1
Global Affairs (w/o T&S),India,ACCENTURE PLC,APAC,2025-04-29,4,1,3,0,3
Technical Infrastructure,Utd.Arab Emir.,IRON SYSTEMS INC,EMEA,2025-05-02,8,2,6,0,6
REWS,India,JONES LANG LASALLE INC,APAC,2025-05-02,3,3,0,0,0
Technical Infrastructure,United States,ADECCO GROUP AG,NORTH AMERICA,2025-04-27,8,7,5,0,5
gTech,Portugal,CONCENTRIX,EMEA,2025-04-21,3,5,0,0,0
gTech,India,VACO,APAC,2025-04-29,5,2,3,0,3
REWS,null,SODEXO,APAC,2025-04-24,3,3,0,0,0
Cloud,Philippines,ACCENTURE PLC,APAC,2025-04-24,8,1,7,6,1
Devices & Services,Ireland,ACCENTURE PLC,EMEA,2025-04-24,5,4,3,1,2
Cloud,United States,SERVICESOURCE INTERNATIONAL INC,NORTH AMERICA,2025-05-02,12,1,11,0,11
T&S,India,WIPRO LIMITED,APAC,2025-04-30,3,3,2,0,2
Platforms + Ecosystems,India,MARKETSTAR CORPORATION,APAC,2025-04-30,4,5,1,1,0
REWS,United States,SODEXO,NORTH AMERICA,2025-04-28,3,5,0,0,0
Geo,India,WIPRO LIMITED,APAC,2025-05-01,5,5,2,2,0
gCS,India,WNS (HOLDINGS) LIMITED,APAC,2025-04-24,3,1,2,1,1
REWS,India,COMPASS GROUP PLC,APAC,2025-04-21,3,5,0,0,0
gTech,Greece,TELEPERFORMANCE SE,EMEA,2025-04-22,9,2,7,1,6
YouTube,India,CONCENTRIX,APAC,2025-04-30,2,3,0,0,0
Technical Infrastructure,United States,"HOLDER CONSTRUCTION GROUP, LLC",NORTH AMERICA,2025-04-21,1,3,0,0,0
Cloud,India,BRISTLECONE INC.,APAC,2025-04-30,11,1,10,0,10
REWS,Mexico,SODEXO,LATAM,2025-04-21,3,5,0,0,0
T&S,India,ACCENTURE PLC,APAC,2025-04-25,4,2,2,1,1
YouTube,India,ACCENTURE PLC,APAC,2025-04-27,7,5,4,1,3
Technical Infrastructure,United States,ALLIED UNIVERSAL,NORTH AMERICA,2025-04-28,6,4,4,4,0
Ads & Commerce,United States,EPAM SYSTEMS INC,NORTH AMERICA,2025-04-30,3,4,1,0,1
REWS,United States,GARDA WORLD SECURITY CORPORATION,NORTH AMERICA,2025-05-01,7,3,4,3,1
Waymo,India,WIPRO LIMITED,APAC,2025-04-30,2,1,1,0,1
REWS,India,SODEXO,APAC,2025-04-22,1,1,0,0,0
Corp Eng,United States,ASTREYA PARTNERS INC,NORTH AMERICA,2025-04-21,2,4,0,0,0
Waymo,United States,TRANSDEV,NORTH AMERICA,2025-05-01,7,2,5,0,5
REWS,India,JAGUAR SECURITY SERVICES PVT. LTD.,APAC,2025-04-22,3,1,2,0,2
gCS,India,ACCENTURE PLC,APAC,2025-04-22,5,1,4,0,4
Devices & Services,United States,"EMBEDDED RESOURCE GROUP, INC.",NORTH AMERICA,2025-04-23,7,3,4,0,4
T&S,India,WIPRO LIMITED,APAC,2025-04-27,4,1,3,0,3
Technical Infrastructure,United States,THE WHITING TURNER CONTRACTING COMPANY,NORTH AMERICA,2025-04-21,12,4,10,0,10
Technical Infrastructure,Finland,ADECCO GROUP AG,EMEA,2025-04-28,8,5,5,4,1
Technical Infrastructure,null,"HOLDER CONSTRUCTION GROUP, LLC",NORTH AMERICA,2025-05-01,3,3,0,0,0
Waymo,India,COGNIZANT TECHNOLOGY SOLUTIONS CORPORATION,APAC,2025-04-21,1,3,0,0,0
Technical Infrastructure,United States,GXO LOGISTICS WORLDWIDE LLC,NORTH AMERICA,2025-05-01,7,3,4,4,0
Finance,India,KPMG,APAC,2025-04-25,4,2,2,0,2
Marketing,United States,"MAGNIT, LLC",NORTH AMERICA,2025-05-01,6,7,3,2,1
gCS,India,TELEDIRECT PTE LTD,APAC,2025-04-25,3,3,0,0,0
Waymo,India,WIPRO LIMITED,APAC,2025-04-24,3,2,2,1,1
gTech,Brazil,ACCENTURE PLC,LATAM,2025-04-23,5,2,3,2,1
Technical Infrastructure,United States,ALLIED UNIVERSAL,NORTH AMERICA,2025-04-23,8,5,5,4,1
Access,United States,DYCOM INDUSTRIES,NORTH AMERICA,2025-04-25,14,4,10,10,0
Technical Infrastructure,United States,GXO LOGISTICS WORLDWIDE LLC,NORTH AMERICA,2025-04-24,2,2,0,0,0
Technical Infrastructure,India,MOTIVITY LABS INC,APAC,2025-04-28,5,4,1,0,1
REWS,United States,COMPASS GROUP PLC,NORTH AMERICA,2025-05-01,3,3,0,0,0
REWS,United States,ELECTROSONIC LIMITED,NORTH AMERICA,2025-04-28,3,5,0,0,0
gCS,India,REGALIX INC,APAC,2025-04-25,4,3,1,1,0
Technical Infrastructure,United States,SCHENKER,NORTH AMERICA,2025-04-22,11,2,9,8,1
Marketing,United Kingdom,JELLYFISH GROUP LTD,EMEA,2025-04-25,13,2,11,9,2
gTech,Brazil,COGNIZANT TECHNOLOGY SOLUTIONS CORPORATION,LATAM,2025-04-22,4,1,3,3,0
Technical Infrastructure,India,INDIGO TELECOM GROUP LTD,APAC,2025-05-01,3,3,0,0,0
gTech,Japan,ACCENTURE PLC,APAC,2025-04-21,5,2,3,1,2
REWS,India,COMPASS GROUP PLC,APAC,2025-04-28,3,5,0,0,0
Waymo,India,COGNIZANT TECHNOLOGY SOLUTIONS CORPORATION,APAC,2025-04-21,1,3,0,0,0
T&S,Philippines,ACCENTURE PLC,APAC,2025-04-29,10,3,7,3,4
REWS,null,SODEXO,APAC,2025-04-24,3,3,0,0,0
POps,India,KORN FERRY INTERNATIONAL,APAC,2025-04-25,4,1,3,2,1
gTech,India,TECH MAHINDRA LIMITED,APAC,2025-04-27,3,2,1,0,1
YouTube,Malaysia,ACCENTURE PLC,APAC,2025-04-28,3,2,1,0,1
POps,India,RANDSTAD NV,APAC,2025-04-24,10,4,8,0,8
Corp Eng,India,EPAM SYSTEMS INC,APAC,2025-04-24,2,2,0,0,0
Technical Infrastructure,United States,DIRECT LINE GLOBAL LLC,NORTH AMERICA,2025-04-29,2,4,0,0,0
YouTube,Portugal,COGNIZANT TECHNOLOGY SOLUTIONS CORPORATION,EMEA,2025-04-23,7,2,5,5,0
REWS,India,G4S PLC,APAC,2025-04-24,1,1,0,0,0
YouTube,India,CONCENTRIX,APAC,2025-04-24,4,4,2,0,2
YouTube,India,ACCENTURE PLC,APAC,2025-04-22,7,4,5,0,5
Waymo,United States,TRANSDEV,NORTH AMERICA,2025-05-01,7,3,4,1,3
Geo,India,TECH MAHINDRA LIMITED,APAC,2025-04-24,6,6,2,0,2
Devices & Services,India,QUEST GLOBAL SERVICES PTE. LTD.,APAC,2025-04-22,4,6,0,0,0
T&S,India,WIPRO LIMITED,APAC,2025-05-01,4,5,1,0,1
REWS,Spain,COMPASS GROUP PLC,EMEA,2025-04-25,15,11,8,4,4
Devices & Services,Taiwan,TEZERAKT LLC,APAC,2025-04-30,4,5,1,0,1
Technical Infrastructure,United States,DIRECT LINE GLOBAL LLC,NORTH AMERICA,2025-04-22,1,1,0,0,0
Cloud,Philippines,ACCENTURE PLC,APAC,2025-04-28,3,2,1,0,1
Geo,India,WIPRO LIMITED,APAC,2025-04-28,2,4,0,0,0
T&S,Philippines,ACCENTURE PLC,APAC,2025-04-21,5,2,3,0,3
YouTube,India,CONCENTRIX,APAC,2025-04-21,3,2,1,1,0
Devices & Services,India,INFOSYS,APAC,2025-04-24,2,1,1,0,1
REWS,India,COMPASS GROUP PLC,APAC,2025-04-21,3,5,0,0,0
T&S,India,CONCENTRIX,APAC,2025-04-21,4,1,3,1,2
YouTube,India,GENPACT LIMITED,APAC,2025-04-28,3,2,1,1,0
T&S,India,WIPRO LIMITED,APAC,2025-04-25,2,2,0,0,0
gTech,India,COGNIZANT TECHNOLOGY SOLUTIONS CORPORATION,APAC,2025-04-24,4,4,2,2,0
Cloud,El Salvador,SERVICESOURCE INTERNATIONAL INC,LATAM,2025-04-28,3,5,0,0,0
T&S,India,ACCENTURE PLC,APAC,2025-04-28,5,2,3,1,2
YouTube,Philippines,TECH MAHINDRA LIMITED,APAC,2025-05-02,11,4,9,0,9
gTech,India,TELEPERFORMANCE SE,APAC,2025-04-28,5,3,2,2,0
Technical Infrastructure,United States,ALLIED UNIVERSAL,NORTH AMERICA,2025-04-22,1,1,0,0,0
Technical Infrastructure,United States,ALLIED UNIVERSAL,NORTH AMERICA,2025-04-24,3,2,1,0,1
gTech,United States,DELOITTE,NORTH AMERICA,2025-04-22,9,2,7,3,4
gTech,Colombia,CONCENTRIX,LATAM,2025-04-28,3,2,1,0,1
Technical Infrastructure,Singapore,LANTROVISION (S) LTD,APAC,2025-04-27,12,5,9,0,9
Geo,India,ACCENTURE PLC,APAC,2025-04-30,4,4,2,0,2
gTech,India,VIRTUSA CORPORATION,APAC,2025-04-25,3,2,1,0,1
T&S,India,WIPRO LIMITED,APAC,2025-04-28,4,1,3,0,3
Technical Infrastructure,United States,SYNCREON GLOBAL HOLDINGS LIMITED,NORTH AMERICA,2025-04-30,4,4,2,2,0
Technical Infrastructure,null,ALPHA SERVICES CORPORATION,NORTH AMERICA,2025-04-29,3,5,0,0,0
Technical Infrastructure,United States,SCHENKER,NORTH AMERICA,2025-04-23,1,1,0,0,0
Access,United States,DYCOM INDUSTRIES,NORTH AMERICA,2025-04-30,10,6,6,0,6
YouTube,India,CONCENTRIX,APAC,2025-04-22,6,3,3,1,2
gCS,India,REGALIX INC,APAC,2025-04-24,3,3,0,0,0
Technical Infrastructure,United States,GXO LOGISTICS WORLDWIDE LLC,NORTH AMERICA,2025-04-24,2,2,0,0,0
YouTube,India,WIPRO LIMITED,APAC,2025-04-21,5,2,4,2,2
Geo,India,ACCENTURE PLC,APAC,2025-04-28,5,2,3,2,1
gCS,Brazil,TTEC HOLDINGS INC,LATAM,2025-04-24,7,2,5,0,5
Core (w/o Corp Eng),United States,"TECHNOLOGY RESOURCE SOLUTIONS, INC. D/B/A SYNERGIS (VENDOR)",NORTH AMERICA,2025-04-27,6,6,2,1,1
Waymo,United States,ABM INDUSTRIES INCORPORATED,NORTH AMERICA,2025-04-29,3,5,0,0,0
Geo,India,COGNIZANT TECHNOLOGY SOLUTIONS CORPORATION,APAC,2025-04-27,5,2,3,0,3
POps,Poland,RANDSTAD NV,EMEA,2025-04-25,3,2,1,0,1
Geo,India,WIPRO LIMITED,APAC,2025-04-28,2,4,0,0,0
gCS,India,REGALIX INC,APAC,2025-04-24,3,2,1,0,1
Marketing,United States,DELOITTE,NORTH AMERICA,2025-04-22,2,4,0,0,0
T&S,India,WIPRO LIMITED,APAC,2025-04-25,2,2,0,0,0
Technical Infrastructure,United States,M A MORTENSON COMPANY,NORTH AMERICA,2025-05-01,14,4,12,1,11
Technical Infrastructure,United States,SCHENKER,NORTH AMERICA,2025-04-22,5,3,2,2,0
YouTube,India,GENPACT LIMITED,APAC,2025-04-28,3,2,1,1,0
Search,India,ACCENTURE PLC,APAC,2025-04-24,6,8,0,0,0
Technical Infrastructure,United States,"HOLDER CONSTRUCTION GROUP, LLC",NORTH AMERICA,2025-05-02,3,3,0,0,0
REWS,null,PROPARK AMERICA WEST LLC,NORTH AMERICA,2025-04-29,3,5,0,0,0
YouTube,India,GENPACT LIMITED,APAC,2025-04-28,3,2,1,1,0
gTech,India,VIRTUSA CORPORATION,APAC,2025-04-25,3,2,1,0,1
Search,null,"TASKUS, INC.",APAC,2025-05-02,3,3,0,0,0
Technical Infrastructure,null,CERTIFIED MAINTENANCE SERVICE INC.,NORTH AMERICA,2025-04-21,3,5,0,0,0
Marketing,Colombia,HUGE LLC,LATAM,2025-04-29,13,4,11,2,9
REWS,United States,KPMG,NORTH AMERICA,2025-04-24,10,4,8,0,8
Geo,India,WIPRO LIMITED,APAC,2025-04-28,3,5,0,0,0
T&S,India,WIPRO LIMITED,APAC,2025-04-23,4,1,3,1,2
Technical Infrastructure,United States,SCHENKER,NORTH AMERICA,2025-04-29,8,5,5,3,2
YouTube,India,CONCENTRIX,APAC,2025-04-25,5,4,3,0,3
gCS,India,WNS (HOLDINGS) LIMITED,APAC,2025-04-23,2,null,2,2,0
GBO (w/o gTech & gCS),India,ACCENTURE PLC,APAC,2025-04-24,2,1,1,1,0
gCS,India,ACCENTURE PLC,APAC,2025-04-21,8,1,7,7,0
Access,United States,DYCOM INDUSTRIES,NORTH AMERICA,2025-05-01,7,6,3,0,3
gTech,India,QUALITEST,APAC,2025-04-28,4,6,0,0,0
YouTube,Philippines,COGNIZANT TECHNOLOGY SOLUTIONS CORPORATION,APAC,2025-04-22,3,4,1,1,0
REWS,United States,JONES LANG LASALLE INC,NORTH AMERICA,2025-04-28,1,3,0,0,0
YouTube,Portugal,COGNIZANT TECHNOLOGY SOLUTIONS CORPORATION,EMEA,2025-04-23,7,2,5,3,2
Technical Infrastructure,Uruguay,ANCHORBUOY LIMITED,LATAM,2025-04-30,17,2,15,14,1
T&S,India,ACCENTURE PLC,APAC,2025-04-21,4,1,3,1,2
YouTube,India,WIPRO LIMITED,APAC,2025-04-27,2,1,1,0,1
Technical Infrastructure,Netherlands,SYNCREON GLOBAL HOLDINGS LIMITED,EMEA,2025-04-28,4,6,0,0,0
REWS,India,CBRE GROUP INC,APAC,2025-04-29,3,5,0,0,0
Technical Infrastructure,United States,GXO LOGISTICS WORLDWIDE LLC,NORTH AMERICA,2025-04-25,3,2,1,0,1
REWS,India,JONES LANG LASALLE INC,APAC,2025-05-02,3,3,0,0,0
T&S,India,CONCENTRIX,APAC,2025-04-25,4,3,1,1,0
GBO (w/o gTech & gCS),United States,TIER1 IMPACT PBC INC DBA TIER1 PERFORMANCE,NORTH AMERICA,2025-04-29,8,5,5,5,0
Technical Infrastructure,United States,GXO LOGISTICS WORLDWIDE LLC,NORTH AMERICA,2025-04-30,6,3,3,0,3
Cloud,United States,CARAHSOFT TECHNOLOGY CORP,NORTH AMERICA,2025-05-02,3,3,0,0,0
Technical Infrastructure,India,WNS (HOLDINGS) LIMITED,APAC,2025-04-21,4,3,1,1,0
Technical Infrastructure,United States,GXO LOGISTICS WORLDWIDE LLC,NORTH AMERICA,2025-05-02,7,5,4,0,4
Geo,Poland,ACCENTURE PLC,EMEA,2025-04-23,9,5,6,0,6
T&S,India,WIPRO LIMITED,APAC,2025-04-25,3,1,2,0,2
T&S,Philippines,ACCENTURE PLC,APAC,2025-04-29,10,3,7,4,3
Geo,India,COGNIZANT TECHNOLOGY SOLUTIONS CORPORATION,APAC,2025-05-01,5,6,1,0,1
T&S,India,WIPRO LIMITED,APAC,2025-04-28,7,1,6,6,0
Technical Infrastructure,United States,TURNER & TOWNSEND PARTNERS LLP,NORTH AMERICA,2025-04-24,12,3,9,0,9
Waymo,United States,"TASKUS, INC.",NORTH AMERICA,2025-04-23,2,1,1,0,1
gCS,India,TELEDIRECT PTE LTD,APAC,2025-05-02,4,3,1,1,0
Technical Infrastructure,United States,GXO LOGISTICS WORLDWIDE LLC,NORTH AMERICA,2025-04-23,6,2,4,4,0
GBO (w/o gTech & gCS),United States,TIER1 IMPACT PBC INC DBA TIER1 PERFORMANCE,NORTH AMERICA,2025-04-24,5,5,2,2,0
Technical Infrastructure,United States,"HOLDER CONSTRUCTION GROUP, LLC",NORTH AMERICA,2025-04-29,3,5,0,0,0
Technical Infrastructure,United States,DIRECT LINE GLOBAL LLC,NORTH AMERICA,2025-04-29,2,4,0,0,0
gTech,Portugal,TELEPERFORMANCE SE,EMEA,2025-04-21,6,5,3,0,3
REWS,United States,ELECTROSONIC LIMITED,NORTH AMERICA,2025-04-29,4,6,0,0,0
gTech,India,COGNIZANT TECHNOLOGY SOLUTIONS CORPORATION,APAC,2025-04-30,5,5,2,2,0
Waymo,India,WIPRO LIMITED,APAC,2025-04-30,6,1,5,5,0
gTech,Portugal,TELEPERFORMANCE SE,EMEA,2025-04-23,5,1,4,3,1
Cloud,India,COGNIZANT TECHNOLOGY SOLUTIONS CORPORATION,APAC,2025-05-02,6,5,3,3,0
gTech,India,TELEPERFORMANCE SE,APAC,2025-04-29,6,4,2,2,0
gCS,India,REGALIX INC,APAC,2025-04-25,4,3,1,1,0
Technical Infrastructure,United States,"ROONEY HOLDINGS, INC.",NORTH AMERICA,2025-05-01,3,3,0,0,0
Technical Infrastructure,United States,SCHENKER,NORTH AMERICA,2025-04-24,15,15,4,4,0
Technical Infrastructure,null,CERTIFIED MAINTENANCE SERVICE INC.,NORTH AMERICA,2025-05-01,3,3,0,0,0
Technical Infrastructure,United States,TW CONSTRUCTORS LLC,NORTH AMERICA,2025-04-24,1,1,0,0,0
gTech,India,VIRTUSA CORPORATION,APAC,2025-04-25,3,2,1,1,0
Corp Eng,India,HCL TECHNOLOGIES LTD,APAC,2025-04-23,4,6,0,0,0
REWS,India,JONES LANG LASALLE INC,APAC,2025-04-22,1,1,0,0,0
Geo,India,COGNIZANT TECHNOLOGY SOLUTIONS CORPORATION,APAC,2025-05-02,6,5,3,3,0
Technical Infrastructure,United States,GARDA WORLD SECURITY CORPORATION,NORTH AMERICA,2025-05-02,4,3,1,1,0
Waymo,United States,TRANSDEV,NORTH AMERICA,2025-04-24,7,3,4,1,3
Technical Infrastructure,United States,C D MOODY CONSTRUCTION COMPANY INC,NORTH AMERICA,2025-04-24,3,3,0,0,0
gTech,United States,VACO,NORTH AMERICA,2025-04-30,5,6,1,1,0
YouTube,India,CONCENTRIX,APAC,2025-04-21,2,1,1,0,1
Technical Infrastructure,Switzerland,RM IT PROFESSIONAL RESOURCES AG,EMEA,2025-04-22,4,34,1,0,1
gCS,Brazil,TTEC HOLDINGS INC,LATAM,2025-05-02,7,5,4,4,0
Devices & Services,United States,WIPRO LIMITED,NORTH AMERICA,2025-04-23,8,5,5,0,5
Search,India,VACO,APAC,2025-04-25,4,3,1,0,1
Technical Infrastructure,United States,VISION TECHNOLOGIES INC.,NORTH AMERICA,2025-04-21,8,5,5,0,5
Technical Infrastructure,United States,"ROONEY HOLDINGS, INC.",NORTH AMERICA,2025-05-01,3,3,0,0,0
Cloud,Mexico,TATA GROUP,LATAM,2025-04-25,4,3,1,0,1
gCS,Brazil,ATENTO S.A.,LATAM,2025-04-29,3,5,0,0,0
gTech,India,TELEPERFORMANCE SE,APAC,2025-04-22,5,1,4,1,3
POps,India,KORN FERRY INTERNATIONAL,APAC,2025-04-24,3,1,2,1,1
REWS,United States,JONES LANG LASALLE INC,NORTH AMERICA,2025-04-23,5,2,3,2,1
Technical Infrastructure,United States,ALLIED UNIVERSAL,NORTH AMERICA,2025-04-24,2,1,1,1,0
Cloud,India,BRISTLECONE INC.,APAC,2025-04-29,10,1,9,1,8
Waymo,United States,AMERIT FLEET SOLUTIONS INC.,NORTH AMERICA,2025-04-23,6,3,3,1,2
Technical Infrastructure,United States,"EPC PROJECT MANAGEMENT CONSULTING, LLC",NORTH AMERICA,2025-04-29,8,5,5,2,3
REWS,India,JONES LANG LASALLE INC,APAC,2025-05-02,3,3,0,0,0
gTech,India,COGNIZANT TECHNOLOGY SOLUTIONS CORPORATION,APAC,2025-05-01,3,3,0,0,0
Geo,India,ACCENTURE PLC,APAC,2025-04-24,3,1,2,2,0
YouTube,India,ACCENTURE PLC,APAC,2025-04-21,6,3,5,1,4
Technical Infrastructure,United States,GXO LOGISTICS WORLDWIDE LLC,NORTH AMERICA,2025-04-23,6,2,4,4,0
Access,United States,IBEX HOLDINGS LIMITED,NORTH AMERICA,2025-05-02,6,5,3,0,3
Platforms + Ecosystems,India,VIRTUSA CORPORATION,APAC,2025-04-24,22,3,19,18,1
Technical Infrastructure,United States,ALLIED UNIVERSAL,NORTH AMERICA,2025-04-23,2,null,2,0,2
gCS,Brazil,TTEC HOLDINGS INC,LATAM,2025-04-28,5,4,1,0,1
Cloud,India,DELOITTE,APAC,2025-04-21,4,3,1,1,0
REWS,Philippines,JONES LANG LASALLE INC,APAC,2025-04-29,4,6,0,0,0
gTech,India,TECH MAHINDRA LIMITED,APAC,2025-04-27,3,2,1,1,0
Technical Infrastructure,United States,"CBM OF AMERICA, INC. (VENDOR)",NORTH AMERICA,2025-04-28,11,4,9,1,8
gTech,Philippines,ALORICA INC,APAC,2025-04-22,8,5,5,4,1
REWS,null,SODEXO,APAC,2025-05-02,3,3,0,0,0
Technical Infrastructure,United States,SCHENKER,NORTH AMERICA,2025-05-01,6,1,5,5,0
Waymo,United States,TRANSDEV,NORTH AMERICA,2025-04-21,4,1,3,3,0
REWS,India,SODEXO,APAC,2025-05-02,3,3,0,0,0
Geo,India,ACCENTURE PLC,APAC,2025-04-24,3,1,2,2,0
Finance,India,KPMG,APAC,2025-04-24,3,2,1,0,1
Waymo,United States,TRANSDEV,NORTH AMERICA,2025-04-25,8,6,4,0,4
POps,India,ACCENTURE PLC,APAC,2025-04-25,3,2,1,1,0
REWS,India,JONES LANG LASALLE INC,APAC,2025-04-21,4,6,0,0,0
Waymo,United States,METRO ONE LOSS PREVENTION SERVICES GROUP (GUARD DIVISION) INC,NORTH AMERICA,2025-04-23,9,6,5,3,2
T&S,India,WIPRO LIMITED,APAC,2025-04-29,8,5,5,4,1
Cloud,United States,COGNIZANT TECHNOLOGY SOLUTIONS CORPORATION,NORTH AMERICA,2025-04-22,3,1,2,2,0
Technical Infrastructure,United States,VISION TECHNOLOGIES INC.,NORTH AMERICA,2025-04-30,11,1,10,10,0
Geo,Brazil,COGNIZANT TECHNOLOGY SOLUTIONS CORPORATION,LATAM,2025-05-02,3,3,0,0,0
Geo,India,COGNIZANT TECHNOLOGY SOLUTIONS CORPORATION,APAC,2025-05-02,6,5,3,3,0
Global Affairs (w/o T&S),United States,"CONSILIO, INC",NORTH AMERICA,2025-04-28,7,4,5,0,5
Technical Infrastructure,Belgium,PM GROUP,EMEA,2025-04-23,6,3,3,2,1
Devices & Services,India,HCL TECHNOLOGIES LTD,APAC,2025-04-29,4,2,2,1,1
gCS,India,REGALIX INC,APAC,2025-04-23,2,2,0,0,0
REWS,India,JONES LANG LASALLE INC,APAC,2025-04-25,3,3,0,0,0
Cloud,United States,MANTECH ADVANCED SYSTEMS INTERNATIONAL INC,NORTH AMERICA,2025-04-22,17,5,14,0,14
Technical Infrastructure,United States,SYNCREON GLOBAL HOLDINGS LIMITED,NORTH AMERICA,2025-04-29,6,2,4,3,1
Technical Infrastructure,United States,ALLIED UNIVERSAL,NORTH AMERICA,2025-04-23,2,2,0,0,0
Cloud,India,COGNIZANT TECHNOLOGY SOLUTIONS CORPORATION,APAC,2025-04-24,2,2,0,0,0
T&S,India,ACCENTURE PLC,APAC,2025-04-27,4,1,3,0,3
Technical Infrastructure,United States,ALLIED UNIVERSAL,NORTH AMERICA,2025-04-23,5,5,2,1,1
Technical Infrastructure,United States,J E DUNN CONSTRUCTION COMPANY,NORTH AMERICA,2025-05-02,3,3,0,0,0
Access,India,VIRTUSA CORPORATION,APAC,2025-04-21,2,4,0,0,0
Research,United States,A.G. KUNZ LLC,NORTH AMERICA,2025-04-23,11,3,8,7,1
gTech,India,TECH MAHINDRA LIMITED,APAC,2025-04-27,3,2,1,1,0
REWS,India,JONES LANG LASALLE INC,APAC,2025-04-23,2,2,0,0,0
Geo,India,WIPRO LIMITED,APAC,2025-04-23,2,1,1,0,1
Technical Infrastructure,United Kingdom,SYNERGY SECURITY SOLUTIONS LIMITED,EMEA,2025-05-02,3,3,0,0,0
Technical Infrastructure,Australia,MSS SECURITY PTY LTD,APAC,2025-04-22,5,1,4,3,1
T&S,India,COGNIZANT TECHNOLOGY SOLUTIONS CORPORATION,APAC,2025-04-23,4,4,2,0,2
T&S,India,COGNIZANT TECHNOLOGY SOLUTIONS CORPORATION,APAC,2025-04-21,4,3,1,0,1
Technical Infrastructure,United States,GXO LOGISTICS WORLDWIDE LLC,NORTH AMERICA,2025-04-24,2,2,0,0,0
gCS,India,ACCENTURE PLC,APAC,2025-04-25,3,1,2,1,1
gTech,India,GENPACT LIMITED,APAC,2025-04-23,3,4,1,1,0
Technical Infrastructure,United States,GXO LOGISTICS WORLDWIDE LLC,NORTH AMERICA,2025-04-30,11,3,8,8,0
T&S,India,WIPRO LIMITED,APAC,2025-05-02,3,3,0,0,0
T&S,Poland,MAJOREL GLOBAL,EMEA,2025-04-22,4,2,2,0,2
YouTube,India,CONCENTRIX,APAC,2025-04-21,3,2,1,1,0
Global Affairs (w/o T&S),Brazil,ACCENTURE PLC,LATAM,2025-04-30,5,5,2,2,0
REWS,India,JONES LANG LASALLE INC,APAC,2025-05-02,3,3,0,0,0
REWS,United States,"INTER-CON SECURITY SYSTEMS, INC.",NORTH AMERICA,2025-04-25,9,8,3,2,1
Waymo,United States,TRANSDEV,NORTH AMERICA,2025-04-25,8,3,5,0,5
Access,United States,SORENSEN CRAIG F CONSTRUCTION INC,NORTH AMERICA,2025-05-01,3,1,2,1,1
Waymo,United States,TRANSDEV,NORTH AMERICA,2025-04-25,8,2,6,0,6
REWS,India,SODEXO,APAC,2025-04-22,1,1,0,0,0
YouTube,India,CONCENTRIX,APAC,2025-04-24,4,5,1,1,0
T&S,India,WIPRO LIMITED,APAC,2025-04-25,4,2,2,1,1
gTech,India,TECH MAHINDRA LIMITED,APAC,2025-04-27,3,2,1,1,0
gTech,India,HCL TECHNOLOGIES LTD,APAC,2025-04-21,8,1,7,0,7
Corp Eng,India,LARSEN AND TOUBRO LIMITED,APAC,2025-04-29,3,5,0,0,0
Access,United States,DYCOM INDUSTRIES,NORTH AMERICA,2025-04-25,3,3,0,0,0
Waymo,United States,TRANSDEV,NORTH AMERICA,2025-05-01,7,1,6,3,3
YouTube,Ireland,ACCENTURE PLC,EMEA,2025-04-23,4,5,1,1,0
Technical Infrastructure,null,TW CONSTRUCTORS LLC,NORTH AMERICA,2025-04-22,3,5,0,0,0
Devices & Services,United States,SIEMENS AG,NORTH AMERICA,2025-04-28,6,4,4,2,2
REWS,India,JONES LANG LASALLE INC,APAC,2025-04-22,1,1,0,0,0
Marketing,United States,MARVEL MARKETERS LLC,NORTH AMERICA,2025-04-24,4,3,3,0,3
gCS,India,WNS (HOLDINGS) LIMITED,APAC,2025-04-25,4,2,2,2,0
Cloud,United States,UJET INC,NORTH AMERICA,2025-05-02,8,2,6,4,2
Access,United States,NETCRACKER TECHNOLOGY CORPORATION,NORTH AMERICA,2025-04-22,2,4,0,0,0
Cloud,Philippines,HCL TECHNOLOGIES LTD,APAC,2025-05-02,5,5,2,2,0
Waymo,United States,TRANSDEV,NORTH AMERICA,2025-04-24,7,6,3,0,3
Technical Infrastructure,United States,GXO LOGISTICS WORLDWIDE LLC,NORTH AMERICA,2025-05-01,7,3,4,1,3
Technical Infrastructure,United States,"AKRAYA, INC",NORTH AMERICA,2025-04-28,3,5,0,0,0
REWS,United States,"INTER-CON SECURITY SYSTEMS, INC.",NORTH AMERICA,2025-04-30,4,5,1,0,1
REWS,United States,ARUP GROUP LIMITED,NORTH AMERICA,2025-04-24,11,1,10,0,10
Technical Infrastructure,United States,SAFETYMAX CORPORATION,NORTH AMERICA,2025-04-23,2,2,0,0,0
REWS,India,SODEXO,APAC,2025-04-23,2,2,0,0,0
gTech,India,HCL TECHNOLOGIES LTD,APAC,2025-04-22,3,5,0,0,0
Technical Infrastructure,United States,GXO LOGISTICS WORLDWIDE LLC,NORTH AMERICA,2025-05-01,7,6,3,3,0
gTech,India,VIRTUSA CORPORATION,APAC,2025-05-02,8,3,5,5,0
Technical Infrastructure,United States,M A MORTENSON COMPANY,NORTH AMERICA,2025-04-29,2,4,0,0,0
Cloud,India,ALTRAN GROUP,APAC,2025-04-27,5,1,4,0,4
Waymo,United States,"TASKUS, INC.",NORTH AMERICA,2025-05-02,6,5,3,3,0
Technical Infrastructure,United States,THE WHITING TURNER CONTRACTING COMPANY,NORTH AMERICA,2025-04-23,14,5,11,10,1
REWS,Colombia,G4S PLC,LATAM,2025-04-25,3,3,0,0,0
REWS,United States,SODEXO,NORTH AMERICA,2025-04-28,3,5,0,0,0
Technical Infrastructure,United States,"HOLDER CONSTRUCTION GROUP, LLC",NORTH AMERICA,2025-04-29,3,5,0,0,0
YouTube,India,GENPACT LIMITED,APAC,2025-04-28,3,2,1,0,1
gTech,India,COGNIZANT TECHNOLOGY SOLUTIONS CORPORATION,APAC,2025-04-22,2,4,0,0,0
Technical Infrastructure,Thailand,JONES LANG LASALLE INC,APAC,2025-04-28,13,1,12,0,12
gTech,India,GENPACT LIMITED,APAC,2025-04-24,3,3,0,0,0
gTech,Brazil,CONCENTRIX,LATAM,2025-04-24,3,3,0,0,0
gCS,Philippines,CONCENTRIX,APAC,2025-04-24,2,1,1,1,0
Cloud,Philippines,ACCENTURE PLC,APAC,2025-04-29,4,2,2,2,0
REWS,United States,JONES LANG LASALLE INC,NORTH AMERICA,2025-04-23,5,2,3,3,0
Finance,India,IBM CORPORATION,APAC,2025-04-28,3,1,2,2,0
T&S,India,WIPRO LIMITED,APAC,2025-04-23,4,4,2,0,2
YouTube,Portugal,COGNIZANT TECHNOLOGY SOLUTIONS CORPORATION,EMEA,2025-04-23,7,2,5,5,0
Core (w/o Corp Eng),United States,"MAGNIT, LLC",NORTH AMERICA,2025-05-01,5,6,1,0,1
Technical Infrastructure,Netherlands,SECURITAS AB,EMEA,2025-04-23,5,1,4,4,0
POps,India,RANDSTAD NV,APAC,2025-04-30,5,5,2,0,2
REWS,India,COMPASS GROUP PLC,APAC,2025-04-25,2,2,0,0,0
Technical Infrastructure,United States,MARK G ANDERSON CONSULTANTS INC,NORTH AMERICA,2025-04-28,8,2,6,0,6
Devices & Services,Colombia,HUGE LLC,LATAM,2025-04-23,9,4,7,6,1
YouTube,India,TELEPERFORMANCE SE,APAC,2025-04-28,4,2,2,0,2
REWS,India,JONES LANG LASALLE INC,APAC,2025-04-22,1,1,0,0,0
Technical Infrastructure,United States,"ROONEY HOLDINGS, INC.",NORTH AMERICA,2025-05-01,3,2,1,1,0
Technical Infrastructure,United States,SCHENKER,NORTH AMERICA,2025-04-23,197,14,187,186,1
Technical Infrastructure,United States,"HOLDER CONSTRUCTION GROUP, LLC",NORTH AMERICA,2025-04-23,3,5,0,0,0
Platforms + Ecosystems,United States,SCALENCE LLC,NORTH AMERICA,2025-04-25,3,3,0,0,0
Access,United States,DYCOM INDUSTRIES,NORTH AMERICA,2025-04-30,9,1,8,8,0
Corp Eng,India,IBM CORPORATION,APAC,2025-04-28,3,1,2,0,2
Technical Infrastructure,United States,"T5 DCMC, LLC",NORTH AMERICA,2025-04-23,5,5,2,1,1
Global Affairs (w/o T&S),Singapore,LAWYERS ON DEMAND LIMITED,APAC,2025-04-29,3,4,1,1,0
gTech,India,TELEPERFORMANCE SE,APAC,2025-04-21,5,3,2,2,0
Geo,Brazil,COGNIZANT TECHNOLOGY SOLUTIONS CORPORATION,LATAM,2025-04-23,6,8,0,0,0
gTech,India,VIRTUSA CORPORATION,APAC,2025-04-25,3,2,1,0,1
Technical Infrastructure,null,SCHENKER,NORTH AMERICA,2025-04-25,6,8,0,0,0
REWS,India,JONES LANG LASALLE INC,APAC,2025-05-02,3,3,0,0,0
YouTube,India,COGNIZANT TECHNOLOGY SOLUTIONS CORPORATION,APAC,2025-04-28,2,4,0,0,0
REWS,null,ELECTROSONIC LIMITED,NORTH AMERICA,2025-04-28,3,5,0,0,0
Technical Infrastructure,United States,SCHENKER,NORTH AMERICA,2025-04-24,2,2,0,0,0
YouTube,Philippines,TECH MAHINDRA LIMITED,APAC,2025-05-02,11,4,9,0,9
Waymo,India,WIPRO LIMITED,APAC,2025-04-30,2,1,1,1,0
gTech,Brazil,CONCENTRIX,LATAM,2025-04-29,6,3,3,3,0
Access,United States,SORENSEN CRAIG F CONSTRUCTION INC,NORTH AMERICA,2025-04-28,7,1,6,0,6
Devices & Services,India,TESSOLVE SEMICONDUCTOR PVT LTD,APAC,2025-04-25,2,1,1,1,0
REWS,United States,COMPASS GROUP PLC,NORTH AMERICA,2025-04-24,3,3,0,0,0
YouTube,India,GENPACT LIMITED,APAC,2025-04-28,3,1,2,0,2
gCS,India,REGALIX INC,APAC,2025-04-25,4,3,1,1,0
YouTube,India,CONCENTRIX,APAC,2025-04-22,3,1,2,0,2
Ads & Commerce,Poland,TELUS,EMEA,2025-04-30,4,5,1,0,1
Cloud,India,COGNIZANT TECHNOLOGY SOLUTIONS CORPORATION,APAC,2025-05-02,3,3,0,0,0
REWS,United States,JONES LANG LASALLE INC,NORTH AMERICA,2025-05-02,7,5,4,3,1
Geo,India,COGNIZANT TECHNOLOGY SOLUTIONS CORPORATION,APAC,2025-04-25,2,2,0,0,0
YouTube,India,CONCENTRIX,APAC,2025-04-23,4,6,0,0,0
gTech,India,GENPACT LIMITED,APAC,2025-04-21,1,3,0,0,0
REWS,Taiwan,JONES LANG LASALLE INC,APAC,2025-04-29,4,5,1,0,1
REWS,India,G4S PLC,APAC,2025-04-23,4,1,3,0,3
YouTube,India,GENPACT LIMITED,APAC,2025-04-28,3,2,1,1,0
REWS,null,CBRE GROUP INC,EMEA,2025-05-02,3,3,0,0,0
T&S,India,WIPRO LIMITED,APAC,2025-04-24,2,1,1,0,1
T&S,India,WIPRO LIMITED,APAC,2025-04-25,4,1,3,0,3
YouTube,India,ACCENTURE PLC,APAC,2025-04-21,6,4,4,0,4
gTech,Germany,VACO,EMEA,2025-05-01,6,2,4,4,0
Ads & Commerce,Poland,TELUS,EMEA,2025-04-30,4,5,1,0,1
T&S,India,COGNIZANT TECHNOLOGY SOLUTIONS CORPORATION,APAC,2025-04-21,4,2,2,0,2
Platforms + Ecosystems,United States,MAGIC LEAP INC.,NORTH AMERICA,2025-04-23,5,2,3,0,3
YouTube,India,ACCENTURE PLC,APAC,2025-04-22,7,3,6,0,6
REWS,United States,MC DEAN INC,NORTH AMERICA,2025-04-23,3,4,1,0,1
Technical Infrastructure,United States,MCFARLAND BUILDING GROUP LLC,NORTH AMERICA,2025-04-23,2,2,0,0,0
Technical Infrastructure,United States,GXO LOGISTICS WORLDWIDE LLC,NORTH AMERICA,2025-05-01,7,3,4,4,0
Technical Infrastructure,null,"HOLDER CONSTRUCTION GROUP, LLC",NORTH AMERICA,2025-05-02,3,3,0,0,0
Finance,India,ACCENTURE PLC,APAC,2025-04-29,4,1,3,3,0
Cloud,Philippines,HCL TECHNOLOGIES LTD,APAC,2025-04-30,10,1,9,0,9
T&S,India,WIPRO LIMITED,APAC,2025-04-21,4,1,3,0,3
T&S,India,WIPRO LIMITED,APAC,2025-04-25,2,2,0,0,0
REWS,United States,GRANT THORNTON INTERNATIONAL LTD,NORTH AMERICA,2025-04-24,3,1,2,0,2
Technical Infrastructure,United States,SYNCREON GLOBAL HOLDINGS LIMITED,NORTH AMERICA,2025-04-23,2,1,1,1,0
Technical Infrastructure,null,"HOLDER CONSTRUCTION GROUP, LLC",NORTH AMERICA,2025-04-23,3,5,0,0,0
Access,United States,DYCOM INDUSTRIES,NORTH AMERICA,2025-05-01,16,2,14,12,2
REWS,Poland,CBRE GROUP INC,EMEA,2025-04-22,1,1,0,0,0
POps,India,DELOITTE,APAC,2025-04-29,3,5,0,0,0
Access,United States,"ALAN PLUMMER ASSOCIATES, INC",NORTH AMERICA,2025-04-29,10,1,9,0,9
gTech,Philippines,TELUS,APAC,2025-04-23,2,2,0,0,0
Technical Infrastructure,Ireland,EOS IT SOLUTIONS,EMEA,2025-04-24,26,5,23,1,22
POps,India,RANDSTAD NV,APAC,2025-04-25,11,4,9,0,9
Cloud,Mexico,TATA GROUP,LATAM,2025-04-29,2,4,0,0,0
gCS,India,ACCENTURE PLC,APAC,2025-04-22,5,2,3,3,0
Corp Eng,Ireland,ASTREYA PARTNERS INC,EMEA,2025-04-23,4,1,3,0,3
Technical Infrastructure,United States,SCHENKER,NORTH AMERICA,2025-04-28,4,3,1,1,0
YouTube,India,CONCENTRIX,APAC,2025-04-21,4,2,2,2,0
Cloud,Canada,TELEPERFORMANCE SE,NORTH AMERICA,2025-04-25,3,2,1,0,1
YouTube,India,ACCENTURE PLC,APAC,2025-05-02,5,3,4,0,4
Cloud,India,DELOITTE,APAC,2025-04-22,4,2,2,0,2
Access,United States,"GARY D. NELSON ASSOCIATES, INC.",NORTH AMERICA,2025-04-28,9,8,6,6,0
Cloud,Philippines,ACCENTURE PLC,APAC,2025-04-24,8,2,6,5,1
POps,India,ACCENTURE PLC,APAC,2025-04-22,4,6,0,0,0
Technical Infrastructure,Belgium,GXO LOGISTICS WORLDWIDE LLC,EMEA,2025-04-25,3,2,1,0,1
Waymo,India,WIPRO LIMITED,APAC,2025-04-27,4,1,3,0,3
gTech,Poland,MAJOREL GLOBAL,EMEA,2025-04-29,5,1,4,1,3
Technical Infrastructure,United States,GARDA WORLD SECURITY CORPORATION,NORTH AMERICA,2025-05-02,4,2,2,0,2
Geo,India,ACCENTURE PLC,APAC,2025-04-23,10,2,8,0,8
Technical Infrastructure,United States,GXO LOGISTICS WORLDWIDE LLC,NORTH AMERICA,2025-04-30,6,3,3,2,1
Devices & Services,India,INFOSYS,APAC,2025-04-21,4,1,3,0,3
REWS,India,JAGUAR SECURITY SERVICES PVT. LTD.,APAC,2025-04-23,1,1,0,0,0
gTech,United States,"PINNACLE TECHNICAL RESOURCES, INC., D/B/A PTR GLOBAL, INC.",NORTH AMERICA,2025-05-01,13,16,8,8,0
Geo,India,ACCENTURE PLC,APAC,2025-04-24,12,1,11,0,11
T&S,India,COGNIZANT TECHNOLOGY SOLUTIONS CORPORATION,APAC,2025-04-25,4,1,3,0,3
Technical Infrastructure,United States,GXO LOGISTICS WORLDWIDE LLC,NORTH AMERICA,2025-04-24,2,2,0,0,0
REWS,null,JONES LANG LASALLE INC,APAC,2025-05-02,3,3,0,0,0
Cloud,India,DELOITTE,APAC,2025-04-22,4,2,2,0,2
T&S,India,ACCENTURE PLC,APAC,2025-04-21,14,1,13,1,12
gTech,India,COGNIZANT TECHNOLOGY SOLUTIONS CORPORATION,APAC,2025-04-22,4,1,3,3,0
Platforms + Ecosystems,United States,STELLAR ELEMENTS LLC,NORTH AMERICA,2025-04-23,14,6,10,9,1
Devices & Services,India,L&T TECHNOLOGY SERVICES LTD,APAC,2025-05-02,5,5,2,0,2
gTech,India,TELEPERFORMANCE SE,APAC,2025-04-23,2,1,1,0,1
REWS,United States,JONES LANG LASALLE INC,NORTH AMERICA,2025-04-25,2,2,0,0,0
T&S,India,COGNIZANT TECHNOLOGY SOLUTIONS CORPORATION,APAC,2025-04-28,5,1,4,2,2
T&S,India,WIPRO LIMITED,APAC,2025-04-21,3,2,1,0,1
T&S,India,WIPRO LIMITED,APAC,2025-04-25,2,1,1,0,1
gTech,Malaysia,TELEDIRECT PTE LTD,APAC,2025-04-21,2,1,1,0,1
T&S,Malaysia,ACCENTURE PLC,APAC,2025-04-28,3,2,1,0,1
REWS,United States,PROPARK AMERICA WEST LLC,NORTH AMERICA,2025-04-29,3,5,0,0,0
gTech,Poland,TELEPERFORMANCE SE,EMEA,2025-04-28,3,5,0,0,0
Technical Infrastructure,United States,J E DUNN CONSTRUCTION COMPANY,NORTH AMERICA,2025-05-02,3,3,0,0,0
Waymo,India,WIPRO LIMITED,APAC,2025-04-22,1,2,0,0,0
gTech,India,ACCENTURE PLC,APAC,2025-05-01,8,1,7,7,0
Technical Infrastructure,United States,"HOLDER CONSTRUCTION GROUP, LLC",NORTH AMERICA,2025-05-02,3,3,0,0,0
YouTube,India,CONCENTRIX,APAC,2025-04-21,3,5,0,0,0
Technical Infrastructure,null,J E DUNN CONSTRUCTION COMPANY,NORTH AMERICA,2025-05-02,3,3,0,0,0
Finance,India,PWC,APAC,2025-04-24,2,2,0,0,0
Waymo,India,COGNIZANT TECHNOLOGY SOLUTIONS CORPORATION,APAC,2025-04-30,2,2,0,0,0
Geo,India,ACCENTURE PLC,APAC,2025-05-02,6,5,3,2,1
Technical Infrastructure,India,MOTIVITY LABS INC,APAC,2025-04-28,5,3,2,2,0
REWS,null,STANTEC INC.,NORTH AMERICA,2025-04-29,3,5,0,0,0
Geo,India,WIPRO LIMITED,APAC,2025-04-23,2,1,1,0,1
YouTube,India,GENPACT LIMITED,APAC,2025-04-28,3,2,1,1,0
Platforms + Ecosystems,United States,COGNIZANT TECHNOLOGY SOLUTIONS CORPORATION,NORTH AMERICA,2025-04-22,3,5,0,0,0
Cloud,India,UBER TECHNOLOGIES INC,APAC,2025-05-01,7,2,5,4,1
Cloud,United States,"MAGNIT, LLC",NORTH AMERICA,2025-04-29,14,32,11,11,0
Cloud,India,SCALENCE LLC,APAC,2025-04-21,3,1,2,1,1
Technical Infrastructure,United States,ALLIED UNIVERSAL,NORTH AMERICA,2025-04-24,2,2,0,0,0
Platforms + Ecosystems,India,BAYONE SOLUTIONS INC.,APAC,2025-04-21,9,3,6,2,4
Devices & Services,United States,MOSAIC US HOLDINGS INC,NORTH AMERICA,2025-04-25,9,3,6,0,6
Technical Infrastructure,United States,GARDA WORLD SECURITY CORPORATION,NORTH AMERICA,2025-04-23,5,5,2,1,1
Cloud,United States,NETAPP INC,NORTH AMERICA,2025-05-01,12,3,9,0,9
Technical Infrastructure,United States,AMENTUM COMMERCIAL OPERATIONS INC,NORTH AMERICA,2025-04-30,2,1,1,0,1
YouTube,India,ACCENTURE PLC,APAC,2025-05-02,6,4,4,0,4
Technical Infrastructure,United States,GXO LOGISTICS WORLDWIDE LLC,NORTH AMERICA,2025-04-25,3,2,1,0,1
gTech,Brazil,CONCENTRIX,LATAM,2025-04-24,3,3,0,0,0
gTech,Poland,TELEPERFORMANCE SE,EMEA,2025-04-28,3,5,0,0,0
Devices & Services,India,ACCENTURE PLC,APAC,2025-04-28,7,6,3,3,0
Technical Infrastructure,United States,SYNCREON GLOBAL HOLDINGS LIMITED,NORTH AMERICA,2025-05-02,25,3,24,19,5
Technical Infrastructure,null,EVERGREEN JANITORIAL SERVICES INC,NORTH AMERICA,2025-04-25,3,3,0,0,0
Cloud,United States,ACCENTURE PLC,NORTH AMERICA,2025-04-22,4,1,3,0,3
Finance,United States,SOLOMONEDWARDSGROUP LLC,NORTH AMERICA,2025-04-30,3,5,0,0,0
gTech,India,COGNIZANT TECHNOLOGY SOLUTIONS CORPORATION,APAC,2025-04-22,1,1,0,0,0
POps,India,RANDSTAD NV,APAC,2025-04-29,10,1,9,4,5
Finance,United States,ERNST AND YOUNG LLP,NORTH AMERICA,2025-04-24,5,1,4,1,3
gTech,India,COGNIZANT TECHNOLOGY SOLUTIONS CORPORATION,APAC,2025-05-01,3,3,0,0,0
Search,India,GLOBALLOGIC INC,APAC,2025-05-02,3,3,0,0,0
T&S,India,WIPRO LIMITED,APAC,2025-05-02,7,2,5,0,5
Technical Infrastructure,United States,DIRECT LINE GLOBAL LLC,NORTH AMERICA,2025-04-25,2,2,0,0,0
gCS,India,ACCENTURE PLC,APAC,2025-04-29,6,1,5,0,5
Cloud,Spain,TELEPERFORMANCE SE,EMEA,2025-04-29,4,5,1,1,0
REWS,Brazil,SODEXO,LATAM,2025-05-02,3,3,0,0,0
Cloud,India,HCL TECHNOLOGIES LTD,APAC,2025-04-22,1,1,0,0,0
REWS,India,JAGUAR SECURITY SERVICES PVT. LTD.,APAC,2025-04-23,1,1,0,0,0
Cloud,Bulgaria,SERVICESOURCE INTERNATIONAL INC,EMEA,2025-04-25,10,3,9,8,1
gTech,Colombia,CONCENTRIX,LATAM,2025-04-25,2,2,0,0,0
gTech,India,TECH MAHINDRA LIMITED,APAC,2025-04-21,3,5,0,0,0
Geo,Poland,EXECUTE APPS LTD,EMEA,2025-04-25,7,2,5,2,3
Global Affairs (w/o T&S),United States,"CONSILIO, INC",NORTH AMERICA,2025-04-28,7,5,4,3,1
Technical Infrastructure,United States,ALLIED UNIVERSAL,NORTH AMERICA,2025-04-24,3,2,1,0,1
Technical Infrastructure,United States,GXO LOGISTICS WORLDWIDE LLC,NORTH AMERICA,2025-04-25,13,2,11,0,11
Finance,United States,"MAGNIT, LLC",NORTH AMERICA,2025-04-29,8,7,5,0,5
Technical Infrastructure,United States,"HOLDER CONSTRUCTION GROUP, LLC",NORTH AMERICA,2025-05-01,3,3,0,0,0
gTech,India,TELEPERFORMANCE SE,APAC,2025-04-22,6,3,3,0,3
Ads & Commerce,India,GLOBALLOGIC INC,APAC,2025-04-27,5,1,4,0,4
gCS,India,ACCENTURE PLC,APAC,2025-04-30,6,2,4,4,0
gTech,null,TELEPERFORMANCE SE,APAC,2025-04-25,3,3,0,0,0
T&S,India,WIPRO LIMITED,APAC,2025-04-23,6,3,3,0,3
Marketing,Indonesia,MASH BRANDS PTY LTD,APAC,2025-04-30,5,2,3,0,3
Technical Infrastructure,United States,"HOLDER CONSTRUCTION GROUP, LLC",NORTH AMERICA,2025-04-25,4,4,0,0,0
YouTube,Romania,GENPACT LIMITED,EMEA,2025-04-29,5,6,1,0,1
T&S,India,WIPRO LIMITED,APAC,2025-04-30,3,3,2,1,1
Waymo,Philippines,COGNIZANT TECHNOLOGY SOLUTIONS CORPORATION,APAC,2025-04-28,3,2,1,1,0
Waymo,United States,TRANSDEV,NORTH AMERICA,2025-05-01,7,2,5,3,2
Technical Infrastructure,United States,GXO LOGISTICS WORLDWIDE LLC,NORTH AMERICA,2025-04-29,5,3,2,0,2
gCS,India,REGALIX INC,APAC,2025-04-25,4,3,1,1,0
Technical Infrastructure,United States,ALLIED UNIVERSAL,NORTH AMERICA,2025-04-24,3,2,1,1,0
gTech,India,COGNIZANT TECHNOLOGY SOLUTIONS CORPORATION,APAC,2025-04-25,3,2,1,1,0
Technical Infrastructure,United States,GXO LOGISTICS WORLDWIDE LLC,NORTH AMERICA,2025-04-21,4,2,2,1,1
T&S,Ireland,ACCENTURE PLC,EMEA,2025-04-23,4,5,1,0,1
Waymo,United States,METRO ONE LOSS PREVENTION SERVICES GROUP (GUARD DIVISION) INC,NORTH AMERICA,2025-04-22,8,5,5,0,5
Research,United States,A.G. KUNZ LLC,NORTH AMERICA,2025-04-21,9,1,8,8,0
Technical Infrastructure,United States,SCHENKER,NORTH AMERICA,2025-04-23,1,1,0,0,0
gTech,Germany,VACO,EMEA,2025-05-02,7,5,4,3,1
Technical Infrastructure,United States,GXO LOGISTICS WORLDWIDE LLC,NORTH AMERICA,2025-05-02,3,3,0,0,0
Technical Infrastructure,United States,ALLIED UNIVERSAL,NORTH AMERICA,2025-04-23,5,2,3,3,0
gTech,India,VIRTUSA CORPORATION,APAC,2025-04-25,3,3,0,0,0
Waymo,India,COGNIZANT TECHNOLOGY SOLUTIONS CORPORATION,APAC,2025-04-30,2,2,0,0,0
Search,India,GLOBALLOGIC INC,APAC,2025-05-02,3,3,0,0,0
Geo,India,COGNIZANT TECHNOLOGY SOLUTIONS CORPORATION,APAC,2025-04-25,2,2,0,0,0
Devices & Services,India,TESSOLVE SEMICONDUCTOR PVT LTD,APAC,2025-04-22,4,6,0,0,0
gTech,Greece,TELEPERFORMANCE SE,EMEA,2025-05-01,3,2,1,0,1
Technical Infrastructure,United States,"HOLDER CONSTRUCTION GROUP, LLC",NORTH AMERICA,2025-04-21,2,4,0,0,0
T&S,India,WIPRO LIMITED,APAC,2025-04-30,5,2,3,1,2
Waymo,India,WIPRO LIMITED,APAC,2025-04-27,4,1,3,0,3
gCS,India,REGALIX INC,APAC,2025-04-25,4,3,1,1,0
Geo,India,COGNIZANT TECHNOLOGY SOLUTIONS CORPORATION,APAC,2025-04-28,3,2,1,0,1
gCS,Brazil,TTEC HOLDINGS INC,LATAM,2025-04-25,3,3,0,0,0
Cloud,India,HCL TECHNOLOGIES LTD,APAC,2025-04-22,2,3,1,0,1
Platforms + Ecosystems,Mexico,COGNIZANT TECHNOLOGY SOLUTIONS CORPORATION,LATAM,2025-04-21,3,5,0,0,0
Waymo,United States,MAGNA INTERNATIONAL INC.,NORTH AMERICA,2025-04-24,3,1,2,2,0
REWS,United States,JONES LANG LASALLE INC,NORTH AMERICA,2025-04-28,1,3,0,0,0
Technical Infrastructure,null,NIPPON TELEGRAPH AND TELEPHONE CORPORATION,APAC,2025-04-21,3,5,0,0,0
REWS,null,COMPASS GROUP PLC,EMEA,2025-04-29,3,5,0,0,0
Corp Eng,India,MOVATE TECHNOLOGIES PRIVATE LIMITED,APAC,2025-04-30,5,2,3,0,3
Technical Infrastructure,null,"HOLDER CONSTRUCTION GROUP, LLC",NORTH AMERICA,2025-05-01,3,3,0,0,0
DeepMind,United States,SCALE AI INC,NORTH AMERICA,2025-04-21,21,6,17,7,10
REWS,United States,SYSTEM ONE HOLDINGS LLC DBA TEAMPEOPLE,NORTH AMERICA,2025-04-22,5,3,2,0,2
Technical Infrastructure,United States,GXO LOGISTICS WORLDWIDE LLC,NORTH AMERICA,2025-04-23,16,3,13,9,4
gTech,India,TELEPERFORMANCE SE,APAC,2025-04-30,2,2,1,0,1
Cloud,India,BRISTLECONE INC.,APAC,2025-04-28,9,1,8,1,7
gCS,Canada,TELEPERFORMANCE SE,NORTH AMERICA,2025-05-02,7,1,6,2,4
Technical Infrastructure,United States,SYNCREON GLOBAL HOLDINGS LIMITED,NORTH AMERICA,2025-05-01,17,3,14,14,0
Technical Infrastructure,United States,C D MOODY CONSTRUCTION COMPANY INC,NORTH AMERICA,2025-04-24,3,3,0,0,0
REWS,null,THE GASTRONOME LTD,EMEA,2025-04-28,3,5,0,0,0
gTech,India,COGNIZANT TECHNOLOGY SOLUTIONS CORPORATION,APAC,2025-04-29,3,5,0,0,0
Technical Infrastructure,United Kingdom,ARCADIS NV,EMEA,2025-05-01,6,2,4,4,0
YouTube,United States,ACCENTURE PLC,NORTH AMERICA,2025-05-02,4,2,2,2,0
gTech,India,TELEPERFORMANCE SE,APAC,2025-04-22,5,2,3,1,2
Technical Infrastructure,Chile,SISTEMAS CONTRA INCENDIOS EUROCOMERCIAL LTDA,LATAM,2025-04-28,3,5,0,0,0
REWS,United States,PFC GROUP OF COMPANIES,NORTH AMERICA,2025-04-25,4,3,1,0,1
YouTube,India,CONCENTRIX,APAC,2025-04-21,3,2,1,1,0
POps,India,ACCENTURE PLC,APAC,2025-04-21,3,2,1,0,1
Technical Infrastructure,Thailand,JONES LANG LASALLE INC,APAC,2025-04-25,16,4,14,0,14
gCS,Brazil,TTEC HOLDINGS INC,LATAM,2025-04-29,6,3,3,1,2
gCS,India,ACCENTURE PLC,APAC,2025-04-25,9,2,7,0,7
T&S,India,WIPRO LIMITED,APAC,2025-04-30,3,4,1,0,1
Marketing,United States,"GARY D. NELSON ASSOCIATES, INC.",NORTH AMERICA,2025-04-28,7,7,3,0,3
Technical Infrastructure,United States,GARDA WORLD SECURITY CORPORATION,NORTH AMERICA,2025-04-24,3,2,1,0,1
POps,Canada,HR PATH SAS,NORTH AMERICA,2025-04-29,12,6,8,8,0
YouTube,Portugal,COGNIZANT TECHNOLOGY SOLUTIONS CORPORATION,EMEA,2025-04-24,5,4,3,0,3
Technical Infrastructure,Netherlands,SYNCREON GLOBAL HOLDINGS LIMITED,EMEA,2025-04-28,4,1,3,3,0
Corp Eng,United States,DELOITTE,NORTH AMERICA,2025-04-24,8,2,6,3,3
Technical Infrastructure,United States,TW CONSTRUCTORS LLC,NORTH AMERICA,2025-04-24,2,2,0,0,0
Devices & Services,Taiwan,SGS S.A.,APAC,2025-04-23,7,3,4,0,4
Cloud,Philippines,HCL TECHNOLOGIES LTD,APAC,2025-05-01,4,4,2,0,2
Cloud,India,HCL TECHNOLOGIES LTD,APAC,2025-04-23,2,1,1,0,1
Technical Infrastructure,United States,GXO LOGISTICS WORLDWIDE LLC,NORTH AMERICA,2025-04-21,4,2,2,0,2
T&S,Ireland,ACCENTURE PLC,EMEA,2025-04-29,5,2,3,0,3
gTech,Philippines,TELUS,APAC,2025-04-22,2,4,0,0,0
gCS,India,WNS (HOLDINGS) LIMITED,APAC,2025-04-24,3,1,2,2,0
gCS,Spain,TELEPERFORMANCE SE,EMEA,2025-04-24,2,1,1,1,0
Geo,India,WIPRO LIMITED,APAC,2025-04-23,2,1,1,0,1
REWS,United States,COMPASS GROUP PLC,NORTH AMERICA,2025-04-22,1,1,0,0,0
Technical Infrastructure,null,SATURN PARTNERS LLC,NORTH AMERICA,2025-04-24,3,3,0,0,0
Cloud,Mexico,TATA GROUP,LATAM,2025-04-21,7,5,4,4,0
Waymo,United States,"THE ERM GROUP, INC.",NORTH AMERICA,2025-04-24,3,1,2,1,1
REWS,India,JONES LANG LASALLE INC,APAC,2025-04-23,1,1,0,0,0
Waymo,United States,METRO ONE LOSS PREVENTION SERVICES GROUP (GUARD DIVISION) INC,NORTH AMERICA,2025-04-30,14,5,11,10,1
Cloud,India,INFOSYS,APAC,2025-04-25,3,3,0,0,0
Technical Infrastructure,United States,SCHENKER,NORTH AMERICA,2025-04-23,2,2,0,0,0
Platforms + Ecosystems,United States,WIPRO LIMITED,NORTH AMERICA,2025-04-30,3,5,0,0,0
gTech,United States,VACO,NORTH AMERICA,2025-04-21,3,2,1,0,1
Access,Poland,EPAM SYSTEMS INC,EMEA,2025-04-28,3,2,1,0,1
Technical Infrastructure,null,INDIGO TELECOM GROUP LTD,LATAM,2025-05-01,3,3,0,0,0
Technical Infrastructure,United States,SCHENKER,NORTH AMERICA,2025-04-23,2,2,0,0,0
Cloud,El Salvador,TELUS,LATAM,2025-04-30,2,2,0,0,0
Technical Infrastructure,United States,GXO LOGISTICS WORLDWIDE LLC,NORTH AMERICA,2025-04-22,5,2,3,3,0
Waymo,India,COGNIZANT TECHNOLOGY SOLUTIONS CORPORATION,APAC,2025-04-21,1,3,0,0,0
Access,United States,"GARY D. NELSON ASSOCIATES, INC.",NORTH AMERICA,2025-04-30,7,7,3,0,3
T&S,India,WIPRO LIMITED,APAC,2025-04-25,2,2,0,0,0
Technical Infrastructure,Singapore,LANTROVISION (S) LTD,APAC,2025-04-27,5,1,4,0,4
Corp Eng,India,MOVATE TECHNOLOGIES PRIVATE LIMITED,APAC,2025-04-25,4,3,1,0,1
Technical Infrastructure,United States,ALLIED UNIVERSAL,NORTH AMERICA,2025-04-23,2,2,0,0,0
REWS,United States,JONES LANG LASALLE INC,NORTH AMERICA,2025-04-22,4,5,1,0,1
Technical Infrastructure,Thailand,WOOD INTERNATIONAL LIMITED,APAC,2025-04-28,3,1,2,0,2
Platforms + Ecosystems,Sweden,USTWO STUDIO INC,EMEA,2025-04-25,9,3,6,0,6
Waymo,India,COGNIZANT TECHNOLOGY SOLUTIONS CORPORATION,APAC,2025-04-29,3,4,1,1,0
T&S,India,WIPRO LIMITED,APAC,2025-04-25,2,5,0,0,0
REWS,India,JONES LANG LASALLE INC,APAC,2025-04-23,2,2,0,0,0
T&S,India,COGNIZANT TECHNOLOGY SOLUTIONS CORPORATION,APAC,2025-04-23,3,3,2,0,2
Access,United States,"PROJECT RESOURCES GROUP, INC.",NORTH AMERICA,2025-04-25,9,2,7,6,1
Devices & Services,India,EXIMIETAS DESIGN LLC,APAC,2025-04-28,2,4,0,0,0
YouTube,India,ACCENTURE PLC,APAC,2025-04-27,8,5,5,2,3
Geo,India,COGNIZANT TECHNOLOGY SOLUTIONS CORPORATION,APAC,2025-04-28,3,2,1,1,0
Technical Infrastructure,United States,TW CONSTRUCTORS LLC,NORTH AMERICA,2025-04-24,1,1,0,0,0
Technical Infrastructure,United States,VISION TECHNOLOGIES INC.,NORTH AMERICA,2025-04-29,3,5,0,0,0
Waymo,United States,TRANSDEV,NORTH AMERICA,2025-05-02,7,6,3,2,1
REWS,India,COMPASS GROUP PLC,APAC,2025-04-23,2,2,0,0,0
gTech,India,VACO,APAC,2025-04-24,8,2,6,0,6
Platforms + Ecosystems,India,MARKETSTAR CORPORATION,APAC,2025-04-25,2,1,1,0,1
REWS,null,JONES LANG LASALLE INC,APAC,2025-05-02,3,3,0,0,0
Technical Infrastructure,United States,GXO LOGISTICS WORLDWIDE LLC,NORTH AMERICA,2025-04-23,11,3,8,0,8
Technical Infrastructure,United States,GXO LOGISTICS WORLDWIDE LLC,NORTH AMERICA,2025-04-21,12,6,8,8,0
Technical Infrastructure,United States,ALLIED UNIVERSAL,NORTH AMERICA,2025-04-28,8,5,5,4,1
gTech,Portugal,TELEPERFORMANCE SE,EMEA,2025-04-23,8,3,7,0,7
POps,India,RANDSTAD NV,APAC,2025-04-24,6,1,5,0,5
Technical Infrastructure,United States,FORTIS CONSTRUCTION INC,NORTH AMERICA,2025-04-29,11,3,8,0,8
gCS,India,TELEDIRECT PTE LTD,APAC,2025-04-29,5,2,3,3,0
REWS,India,JONES LANG LASALLE INC,APAC,2025-04-23,1,1,0,0,0
Waymo,India,WIPRO LIMITED,APAC,2025-04-27,4,1,3,1,2
Technical Infrastructure,null,MCFARLAND BUILDING GROUP LLC,NORTH AMERICA,2025-04-22,3,5,0,0,0
Technical Infrastructure,Poland,EPAM SYSTEMS INC,EMEA,2025-04-30,6,3,3,2,1
REWS,United States,PROPARK AMERICA WEST LLC,NORTH AMERICA,2025-04-28,2,4,0,0,0
YouTube,India,CONCENTRIX,APAC,2025-04-21,3,2,1,1,0
REWS,Poland,CBRE GROUP INC,EMEA,2025-04-24,2,2,0,0,0
T&S,India,WIPRO LIMITED,APAC,2025-05-01,4,5,1,0,1
gTech,United States,VACO,NORTH AMERICA,2025-04-29,4,6,0,0,0
Technical Infrastructure,United States,ALLIED UNIVERSAL,NORTH AMERICA,2025-04-28,8,5,5,5,0
Technical Infrastructure,Finland,FIBER HIGHWAY FINLAND OY,EMEA,2025-04-24,2,1,1,0,1
T&S,India,WIPRO LIMITED,APAC,2025-04-23,4,4,2,0,2
gTech,India,GENPACT LIMITED,APAC,2025-04-22,1,1,0,0,0
Finance,India,RESOURCES GLOBAL PROFESSIONALS,APAC,2025-04-25,6,1,5,0,5
gTech,United States,VACO,NORTH AMERICA,2025-04-21,3,1,2,0,2
gTech,United States,VACO,NORTH AMERICA,2025-04-27,3,1,2,0,2
REWS,India,SODEXO,APAC,2025-04-23,2,2,0,0,0
gTech,India,COGNIZANT TECHNOLOGY SOLUTIONS CORPORATION,APAC,2025-04-22,4,2,2,1,1
YouTube,India,CONCENTRIX,APAC,2025-04-21,4,1,3,0,3
REWS,United States,ELECTROSONIC LIMITED,NORTH AMERICA,2025-04-22,3,5,0,0,0
gTech,Brazil,COGNIZANT TECHNOLOGY SOLUTIONS CORPORATION,LATAM,2025-04-22,4,2,2,0,2
REWS,Germany,CBRE GROUP INC,EMEA,2025-04-29,3,5,0,0,0
gCS,India,TELEDIRECT PTE LTD,APAC,2025-04-23,2,2,0,0,0
Platforms + Ecosystems,Canada,SCALENCE LLC,NORTH AMERICA,2025-04-24,6,5,3,2,1
REWS,India,COMPASS GROUP PLC,APAC,2025-04-22,3,5,0,0,0
Technical Infrastructure,United States,ALLIED UNIVERSAL,NORTH AMERICA,2025-04-25,3,3,0,0,0
Technical Infrastructure,United States,GXO LOGISTICS WORLDWIDE LLC,NORTH AMERICA,2025-04-25,16,5,13,9,4
DeepMind,null,JAGUAR BUILDING SERVICES LIMITED,EMEA,2025-04-22,0,null,0,0,0
Finance,India,PWC,APAC,2025-04-23,7,1,6,5,1
gTech,Poland,TELEPERFORMANCE SE,EMEA,2025-04-28,3,5,0,0,0
Waymo,United States,TRANSDEV,NORTH AMERICA,2025-05-02,8,2,6,2,4
gTech,Colombia,CONCENTRIX,LATAM,2025-05-01,3,3,0,0,0
Finance,India,ACCENTURE PLC,APAC,2025-04-30,4,4,2,0,2
Geo,India,WIPRO LIMITED,APAC,2025-04-24,1,1,0,0,0
Devices & Services,India,TECH MAHINDRA LIMITED,APAC,2025-04-29,10,3,7,0,7
Cloud,Japan,EPAM SYSTEMS INC,APAC,2025-04-23,2,2,0,0,0
REWS,India,JONES LANG LASALLE INC,APAC,2025-04-24,3,3,0,0,0
Cloud,El Salvador,TELUS,LATAM,2025-05-02,4,3,1,1,0
gTech,Argentina,COGNIZANT TECHNOLOGY SOLUTIONS CORPORATION,LATAM,2025-04-23,10,1,9,2,7
YouTube,India,ACCENTURE PLC,APAC,2025-04-21,6,5,3,0,3
Waymo,India,WIPRO LIMITED,APAC,2025-04-27,4,1,3,1,2
T&S,India,WIPRO LIMITED,APAC,2025-05-02,3,3,0,0,0
Technical Infrastructure,United States,SYNCREON GLOBAL HOLDINGS LIMITED,NORTH AMERICA,2025-04-29,6,2,4,3,1
Technical Infrastructure,United States,MILLER ELECTRIC COMPANY INC,NORTH AMERICA,2025-05-01,3,3,0,0,0
X,United States,RANDSTAD NV,NORTH AMERICA,2025-04-30,23,5,20,20,0
Core (w/o Corp Eng),United States,WHERE THE BUFFALO ROAM,NORTH AMERICA,2025-04-21,3,5,0,0,0
DeepMind,United States,SCALE AI INC,NORTH AMERICA,2025-04-22,17,4,15,11,4
gCS,India,TELEDIRECT PTE LTD,APAC,2025-04-24,3,2,1,1,0
Cloud,Philippines,ACCENTURE PLC,APAC,2025-04-24,10,4,8,0,8
REWS,Portugal,PROSEGUR SA,EMEA,2025-04-22,5,6,1,1,0
YouTube,India,CONCENTRIX,APAC,2025-04-23,6,2,4,1,3
gTech,India,GENPACT LIMITED,APAC,2025-04-29,4,5,1,1,0
REWS,United States,JONES LANG LASALLE INC,NORTH AMERICA,2025-04-29,2,4,0,0,0
REWS,India,G4S PLC,APAC,2025-04-25,2,2,0,0,0
gTech,China,COGNIZANT TECHNOLOGY SOLUTIONS CORPORATION,APAC,2025-04-21,6,4,4,2,2
Technical Infrastructure,United States,SALUTE INCORPORATED,NORTH AMERICA,2025-04-21,4,3,1,0,1
GBO (w/o gTech & gCS),United States,"MAGNIT, LLC",NORTH AMERICA,2025-04-21,8,7,5,0,5
Waymo,India,WIPRO LIMITED,APAC,2025-04-24,3,4,0,0,0
gTech,United States,VACO,NORTH AMERICA,2025-04-29,4,6,0,0,0
Technical Infrastructure,India,JAGUAR SECURITY SERVICES PVT. LTD.,APAC,2025-04-23,5,2,3,2,1
Waymo,India,COGNIZANT TECHNOLOGY SOLUTIONS CORPORATION,APAC,2025-04-30,2,2,0,0,0
Cloud,Philippines,ACCENTURE PLC,APAC,2025-04-21,3,1,2,0,2
Cloud,United States,MANTECH ADVANCED SYSTEMS INTERNATIONAL INC,NORTH AMERICA,2025-04-29,22,7,17,17,0
REWS,India,G4S PLC,APAC,2025-04-30,2,2,0,0,0
YouTube,India,CONCENTRIX,APAC,2025-04-21,3,1,2,2,0
Devices & Services,India,HCL TECHNOLOGIES LTD,APAC,2025-04-23,2,1,1,0,1
Waymo,United States,TRANSDEV,NORTH AMERICA,2025-04-24,7,2,5,0,5
gCS,Brazil,TTEC HOLDINGS INC,LATAM,2025-05-02,4,3,1,1,0
gTech,India,COGNIZANT TECHNOLOGY SOLUTIONS CORPORATION,APAC,2025-04-22,4,2,2,2,0
REWS,India,SODEXO,APAC,2025-04-22,1,1,0,0,0
Access,United States,"CHC CONSULTING, LLC",NORTH AMERICA,2025-04-21,13,5,10,0,10
Waymo,United States,TRANSDEV,NORTH AMERICA,2025-05-01,7,3,4,2,2
Access,United States,DYCOM INDUSTRIES,NORTH AMERICA,2025-04-22,7,5,4,1,3
Technical Infrastructure,null,"HOLDER CONSTRUCTION GROUP, LLC",NORTH AMERICA,2025-05-02,3,3,0,0,0
GBO (w/o gTech & gCS),Singapore,ALLEGIS GROUP SINGAPORE PTE. LTD.,APAC,2025-04-22,5,7,1,0,1
YouTube,Philippines,TECH MAHINDRA LIMITED,APAC,2025-05-02,11,1,10,1,9
Geo,India,COGNIZANT TECHNOLOGY SOLUTIONS CORPORATION,APAC,2025-04-21,4,6,0,0,0
gTech,Philippines,TELUS,APAC,2025-04-22,2,4,0,0,0
Technical Infrastructure,null,DIRECT LINE GLOBAL LLC,NORTH AMERICA,2025-04-28,3,5,0,0,0
gTech,India,TELEPERFORMANCE SE,APAC,2025-04-22,5,1,4,1,3
Finance,India,IBM CORPORATION,APAC,2025-04-30,7,3,4,4,0
Finance,India,KPMG,APAC,2025-04-24,3,1,2,1,1
Cloud,Mexico,TATA GROUP,LATAM,2025-04-21,3,1,2,0,2
Technical Infrastructure,United States,GXO LOGISTICS WORLDWIDE LLC,NORTH AMERICA,2025-04-22,5,2,3,2,1
REWS,null,JONES LANG LASALLE INC,APAC,2025-05-02,3,3,0,0,0
Finance,India,ACCENTURE PLC,APAC,2025-04-29,4,1,3,1,2
Waymo,India,COGNIZANT TECHNOLOGY SOLUTIONS CORPORATION,APAC,2025-04-28,2,4,0,0,0
Platforms + Ecosystems,India,ITTIAM SYSTEMS PVT LTD,APAC,2025-04-28,6,5,3,0,3
Technical Infrastructure,United States,"HOLDER CONSTRUCTION GROUP, LLC",NORTH AMERICA,2025-04-29,1,1,0,0,0
Technical Infrastructure,United States,VISION TECHNOLOGIES INC.,NORTH AMERICA,2025-04-30,3,3,2,1,1
REWS,Canada,GARDA WORLD SECURITY CORPORATION,NORTH AMERICA,2025-04-23,1,1,0,0,0
Waymo,India,WIPRO LIMITED,APAC,2025-04-24,3,2,2,2,0
YouTube,Ireland,ACCENTURE PLC,EMEA,2025-04-28,3,2,1,1,0
gTech,Ireland,ACCENTURE PLC,EMEA,2025-04-28,4,3,1,1,0
Cloud,India,DELOITTE,APAC,2025-04-24,4,4,2,0,2
T&S,India,ACCENTURE PLC,APAC,2025-04-25,4,2,2,2,0
T&S,India,COGNIZANT TECHNOLOGY SOLUTIONS CORPORATION,APAC,2025-04-21,1,null,1,1,0
Technical Infrastructure,United States,SCHENKER,NORTH AMERICA,2025-04-24,3,2,1,1,0
Marketing,Thailand,ACCENTURE PLC,APAC,2025-04-21,4,1,3,1,2
Technical Infrastructure,United States,DIRECT LINE GLOBAL LLC,NORTH AMERICA,2025-04-28,6,5,3,1,2
T&S,India,COGNIZANT TECHNOLOGY SOLUTIONS CORPORATION,APAC,2025-04-30,9,4,7,5,2
Ads & Commerce,India,ENCORA HOLDINGS LIMITED,APAC,2025-04-24,3,1,2,0,2
Technical Infrastructure,United Kingdom,SYNERGY SECURITY SOLUTIONS LIMITED,EMEA,2025-04-23,5,1,4,1,3
Waymo,United States,TRANSDEV,NORTH AMERICA,2025-05-01,7,3,4,2,2
REWS,India,JONES LANG LASALLE INC,APAC,2025-04-22,1,1,0,0,0
REWS,India,JONES LANG LASALLE INC,APAC,2025-04-25,3,3,0,0,0
Geo,India,WIPRO LIMITED,APAC,2025-04-28,2,4,0,0,0
Corp Eng,India,ACCENTURE PLC,APAC,2025-04-23,4,4,2,1,1
Access,United States,ALLO HOLDING LLC,NORTH AMERICA,2025-04-30,12,3,9,8,1
POps,India,RANDSTAD NV,APAC,2025-04-24,10,null,10,0,10
POps,United States,ACCENTURE PLC,NORTH AMERICA,2025-04-23,6,1,5,3,2
Cloud,Spain,TELEPERFORMANCE SE,EMEA,2025-04-28,3,5,0,0,0
gCS,Brazil,ATENTO S.A.,LATAM,2025-04-29,3,5,0,0,0
REWS,United States,PROPARK AMERICA WEST LLC,NORTH AMERICA,2025-04-30,4,4,2,0,2
YouTube,India,ACCENTURE PLC,APAC,2025-04-23,10,1,9,9,0
gTech,India,VIRTUSA CORPORATION,APAC,2025-04-25,3,3,0,0,0
Geo,India,WIPRO LIMITED,APAC,2025-04-22,1,1,0,0,0
gCS,India,ACCENTURE PLC,APAC,2025-04-28,4,1,3,2,1
T&S,India,WIPRO LIMITED,APAC,2025-04-23,4,1,3,0,3
Waymo,India,WIPRO LIMITED,APAC,2025-04-27,4,1,3,0,3
Marketing,United States,"MAGNIT, LLC",NORTH AMERICA,2025-04-30,6,11,1,1,0
gCS,India,REGALIX INC,APAC,2025-05-02,4,3,1,1,0
Devices & Services,United States,"AKRAYA, INC",NORTH AMERICA,2025-05-02,3,3,0,0,0
Technical Infrastructure,United States,GXO LOGISTICS WORLDWIDE LLC,NORTH AMERICA,2025-04-25,21,4,19,15,4
Ads & Commerce,India,WIPRO LIMITED,APAC,2025-04-24,2,2,0,0,0
GBO (w/o gTech & gCS),Singapore,CODIMITE PTE LTD,APAC,2025-04-30,2,2,0,0,0
Waymo,India,COGNIZANT TECHNOLOGY SOLUTIONS CORPORATION,APAC,2025-04-25,3,1,2,2,0
Platforms + Ecosystems,India,INFOSYS,APAC,2025-04-24,7,1,6,0,6
gTech,India,COGNIZANT TECHNOLOGY SOLUTIONS CORPORATION,APAC,2025-05-02,4,3,1,0,1
Technical Infrastructure,United States,TW CONSTRUCTORS LLC,NORTH AMERICA,2025-04-29,3,5,0,0,0
YouTube,India,GENPACT LIMITED,APAC,2025-04-28,3,2,1,0,1
T&S,India,WIPRO LIMITED,APAC,2025-05-02,3,3,0,0,0
gCS,China,ACCENTURE PLC,APAC,2025-04-30,6,1,5,3,2
T&S,India,WIPRO LIMITED,APAC,2025-05-01,4,5,1,0,1
YouTube,India,CONCENTRIX,APAC,2025-04-21,3,2,1,1,0
Technical Infrastructure,null,SISTEMAS CONTRA INCENDIOS EUROCOMERCIAL LTDA,LATAM,2025-04-28,3,5,0,0,0
Waymo,United States,COGNIZANT TECHNOLOGY SOLUTIONS CORPORATION,NORTH AMERICA,2025-04-22,5,1,4,3,1
Technical Infrastructure,United States,SCHENKER,NORTH AMERICA,2025-04-24,2,2,0,0,0
Waymo,United States,TRANSDEV,NORTH AMERICA,2025-04-30,10,5,7,7,0
YouTube,India,ACCENTURE PLC,APAC,2025-04-29,5,3,2,2,0
REWS,India,COMPASS GROUP PLC,APAC,2025-04-25,2,2,0,0,0
Technical Infrastructure,United States,MCFARLAND BUILDING GROUP LLC,NORTH AMERICA,2025-04-24,3,3,0,0,0
gTech,Colombia,CONCENTRIX,LATAM,2025-04-22,1,1,0,0,0
Technical Infrastructure,Netherlands,SCHENKER,EMEA,2025-05-01,4,5,1,1,0
YouTube,India,CONCENTRIX,APAC,2025-04-23,1,1,0,0,0
Technical Infrastructure,Netherlands,SYNCREON GLOBAL HOLDINGS LIMITED,EMEA,2025-04-29,5,3,2,1,1
Access,United States,ONUG SOLUTIONS LLC,NORTH AMERICA,2025-04-28,4,2,2,1,1
Geo,India,WIPRO LIMITED,APAC,2025-04-29,3,5,0,0,0
Cloud,Mexico,TATA GROUP,LATAM,2025-04-22,15,3,12,2,10
gTech,Mexico,QUALITEST,LATAM,2025-04-28,5,3,2,0,2
gTech,India,TELEPERFORMANCE SE,APAC,2025-04-29,1,2,0,0,0
Cloud,Philippines,ACCENTURE PLC,APAC,2025-04-22,5,3,2,1,1
Waymo,United States,UBER TECHNOLOGIES INC,NORTH AMERICA,2025-04-28,7,7,2,2,0
Technical Infrastructure,United States,SCHENKER,NORTH AMERICA,2025-04-24,3,3,0,0,0
DeepMind,United Kingdom,HARVEY NASH PLC,EMEA,2025-05-01,7,7,5,3,2
T&S,Portugal,COGNIZANT TECHNOLOGY SOLUTIONS CORPORATION,EMEA,2025-04-23,7,1,6,4,2
T&S,India,WIPRO LIMITED,APAC,2025-04-25,2,1,1,0,1
Waymo,United States,AUTONATION,NORTH AMERICA,2025-04-28,3,2,1,1,0
T&S,India,WIPRO LIMITED,APAC,2025-05-01,4,5,1,0,1
REWS,United Kingdom,WT PARTNERSHIP S PTE LTD,EMEA,2025-04-23,3,4,1,0,1
Access,United States,DYCOM INDUSTRIES,NORTH AMERICA,2025-04-22,7,5,4,0,4
Platforms + Ecosystems,United States,TATA GROUP,NORTH AMERICA,2025-04-28,15,2,13,0,13
Technical Infrastructure,null,NIPPON TELEGRAPH AND TELEPHONE CORPORATION,APAC,2025-04-21,3,5,0,0,0
Devices & Services,India,WIPRO LIMITED,APAC,2025-04-22,6,7,1,0,1
Technical Infrastructure,United States,ALLIED UNIVERSAL,NORTH AMERICA,2025-04-23,2,2,0,0,0
REWS,United Kingdom,247 NATIONAL LIMITED,EMEA,2025-04-23,10,1,9,2,7
Ads & Commerce,India,FRACTAL ANALYTICS PRIVATE LIMITED,APAC,2025-04-21,4,2,2,2,0
REWS,India,SODEXO,APAC,2025-05-02,3,3,0,0,0
YouTube,India,GENPACT LIMITED,APAC,2025-04-28,3,2,1,1,0
gTech,Brazil,CONCENTRIX,LATAM,2025-04-24,3,3,0,0,0
gTech,India,COGNIZANT TECHNOLOGY SOLUTIONS CORPORATION,APAC,2025-04-21,2,1,1,1,0
REWS,India,JONES LANG LASALLE INC,APAC,2025-04-23,2,2,0,0,0
REWS,India,JONES LANG LASALLE INC,APAC,2025-05-02,3,3,0,0,0
T&S,India,ACCENTURE PLC,APAC,2025-04-27,5,2,3,2,1
T&S,India,WIPRO LIMITED,APAC,2025-04-25,2,2,0,0,0
T&S,Ireland,ACCENTURE PLC,EMEA,2025-04-29,5,2,3,0,3
Waymo,India,WIPRO LIMITED,APAC,2025-04-27,4,1,3,0,3
REWS,United States,JONES LANG LASALLE INC,NORTH AMERICA,2025-04-25,2,2,0,0,0
YouTube,India,CONCENTRIX,APAC,2025-05-02,6,5,3,3,0
Waymo,United States,KPMG,NORTH AMERICA,2025-04-30,3,4,1,0,1
YouTube,India,TELEPERFORMANCE SE,APAC,2025-04-22,4,2,2,1,1
gTech,India,VIRTUSA CORPORATION,APAC,2025-04-25,3,2,1,0,1
Technical Infrastructure,United States,ALLIED UNIVERSAL,NORTH AMERICA,2025-04-22,3,4,1,0,1
Finance,United States,MCKINSEY & COMPANY,NORTH AMERICA,2025-04-28,6,4,4,0,4
REWS,India,JAGUAR SECURITY SERVICES PVT. LTD.,APAC,2025-04-24,2,2,0,0,0
REWS,United States,GARDA WORLD SECURITY CORPORATION,NORTH AMERICA,2025-04-25,10,5,7,6,1
Technical Infrastructure,null,"ROONEY HOLDINGS, INC.",NORTH AMERICA,2025-05-01,3,3,0,0,0
REWS,United States,ELECTROSONIC LIMITED,NORTH AMERICA,2025-04-28,3,5,0,0,0
Technical Infrastructure,null,EVERGREEN JANITORIAL SERVICES INC,NORTH AMERICA,2025-04-25,3,3,0,0,0
T&S,Philippines,ACCENTURE PLC,APAC,2025-04-29,10,2,8,1,7
Geo,India,WIPRO LIMITED,APAC,2025-04-23,2,1,1,0,1
Technical Infrastructure,United States,ALLIED UNIVERSAL,NORTH AMERICA,2025-04-23,2,2,0,0,0
gTech,India,TECH MAHINDRA LIMITED,APAC,2025-04-27,3,2,1,1,0
Waymo,India,WIPRO LIMITED,APAC,2025-04-24,3,4,0,0,0
Technical Infrastructure,United States,GXO LOGISTICS WORLDWIDE LLC,NORTH AMERICA,2025-04-21,4,2,2,1,1
Waymo,United States,METRO ONE LOSS PREVENTION SERVICES GROUP (GUARD DIVISION) INC,NORTH AMERICA,2025-04-25,11,7,6,2,4
T&S,India,WIPRO LIMITED,APAC,2025-04-30,5,2,3,1,2
Technical Infrastructure,United States,GARDA WORLD SECURITY CORPORATION,NORTH AMERICA,2025-05-02,4,3,1,1,0
POps,India,RANDSTAD NV,APAC,2025-04-29,13,5,10,8,2
gTech,Netherlands,ADECCO PERSONEELSDIENSTEN B.V - NETHERLANDS,EMEA,2025-04-25,16,12,8,5,3
Cloud,Mexico,TATA GROUP,LATAM,2025-04-29,6,3,3,1,2
Waymo,India,COGNIZANT TECHNOLOGY SOLUTIONS CORPORATION,APAC,2025-04-21,1,3,0,0,0
Waymo,United States,AMERIT FLEET SOLUTIONS INC.,NORTH AMERICA,2025-04-29,2,4,0,0,0
Cloud,Japan,GLOBALLOGIC INC,APAC,2025-04-21,2,4,0,0,0
Waymo,India,WIPRO LIMITED,APAC,2025-04-24,3,4,0,0,0
Cloud,Mexico,TATA GROUP,LATAM,2025-04-24,2,1,1,0,1
Cloud,India,CREST DATA SYSTEMS,APAC,2025-04-23,5,6,1,0,1
Access,United States,DELOITTE,NORTH AMERICA,2025-04-21,5,4,1,0,1
Cloud,India,CLOUDSUFI INC.,APAC,2025-05-02,14,3,11,0,11
YouTube,Ireland,ACCENTURE PLC,EMEA,2025-04-28,4,1,3,0,3
Technical Infrastructure,null,J E DUNN CONSTRUCTION COMPANY,NORTH AMERICA,2025-04-24,3,3,0,0,0
T&S,Canada,MAGNIT GLOBAL CANADA LTD.,NORTH AMERICA,2025-04-23,4,7,1,0,1
T&S,India,COGNIZANT TECHNOLOGY SOLUTIONS CORPORATION,APAC,2025-04-21,1,3,0,0,0
REWS,United States,"BEAR COMMUNICATIONS, INC",NORTH AMERICA,2025-04-23,14,7,9,0,9
REWS,India,JONES LANG LASALLE INC,APAC,2025-04-25,3,3,0,0,0
gTech,Philippines,COGNIZANT TECHNOLOGY SOLUTIONS CORPORATION,APAC,2025-04-23,2,1,1,1,0
REWS,India,COMPASS GROUP PLC,APAC,2025-04-21,3,5,0,0,0
gTech,Poland,TELEPERFORMANCE SE,EMEA,2025-04-28,3,5,0,0,0
DeepMind,United States,SCALE AI INC,NORTH AMERICA,2025-04-30,18,5,15,15,0
gTech,India,TELEPERFORMANCE SE,APAC,2025-04-22,6,3,3,2,1
gTech,Brazil,CONCENTRIX,LATAM,2025-04-24,3,3,0,0,0
gTech,Colombia,CONCENTRIX,LATAM,2025-04-29,2,4,0,0,0
YouTube,India,CONCENTRIX,APAC,2025-04-23,5,2,3,2,1
POps,India,ACCENTURE PLC,APAC,2025-04-21,3,2,1,1,0
T&S,India,COGNIZANT TECHNOLOGY SOLUTIONS CORPORATION,APAC,2025-04-25,4,1,3,0,3
Platforms + Ecosystems,India,COGNIZANT TECHNOLOGY SOLUTIONS CORPORATION,APAC,2025-04-22,1,1,0,0,0
Technical Infrastructure,null,J E DUNN CONSTRUCTION COMPANY,NORTH AMERICA,2025-04-30,3,5,0,0,0
T&S,India,WIPRO LIMITED,APAC,2025-04-30,5,2,3,1,2
Technical Infrastructure,Finland,ADECCO GROUP AG,EMEA,2025-04-24,8,7,3,0,3
Technical Infrastructure,United States,GXO LOGISTICS WORLDWIDE LLC,NORTH AMERICA,2025-04-25,3,3,0,0,0
T&S,Philippines,ACCENTURE PLC,APAC,2025-04-24,7,6,3,0,3
Geo,India,WIPRO LIMITED,APAC,2025-04-28,2,4,0,0,0
T&S,India,ACCENTURE PLC,APAC,2025-04-22,6,1,5,3,2
gTech,India,TELEPERFORMANCE SE,APAC,2025-04-25,3,2,1,1,0
REWS,Poland,SECURITAS AB,EMEA,2025-04-23,10,5,7,2,5
Technical Infrastructure,United States,"HOLDER CONSTRUCTION GROUP, LLC",NORTH AMERICA,2025-05-01,3,3,0,0,0
Devices & Services,Taiwan,INFOSYS,APAC,2025-04-28,13,1,12,0,12
REWS,United States,ARAMARK HOLDINGS CORPORATION,NORTH AMERICA,2025-04-23,1,1,0,0,0
REWS,India,SODEXO,APAC,2025-04-23,2,2,0,0,0
Platforms + Ecosystems,United States,ICONMA LLC,NORTH AMERICA,2025-05-02,5,10,4,2,2
Geo,India,ACCENTURE PLC,APAC,2025-04-24,3,1,2,2,0
Technical Infrastructure,United States,MC DEAN INC,NORTH AMERICA,2025-04-25,9,2,7,0,7
gTech,Colombia,CONCENTRIX,LATAM,2025-05-02,5,5,2,2,0
Devices & Services,India,HCL TECHNOLOGIES LTD,APAC,2025-04-29,1,1,0,0,0
REWS,India,G4S PLC,APAC,2025-04-30,2,2,0,0,0
Technical Infrastructure,Spain,SCHENKER,EMEA,2025-04-27,4,3,1,0,1
Devices & Services,India,HCL TECHNOLOGIES LTD,APAC,2025-04-23,2,2,0,0,0
Technical Infrastructure,United States,SCHENKER,NORTH AMERICA,2025-04-22,3,1,2,1,1
REWS,India,SODEXO,APAC,2025-04-22,1,1,0,0,0
REWS,Germany,PUETZ SECURITY AG,EMEA,2025-04-23,12,null,12,2,10
Marketing,United States,"MAGNIT, LLC",NORTH AMERICA,2025-04-22,20,7,18,0,18
Corp Eng,United States,ELB PTY LIMITED,NORTH AMERICA,2025-04-24,2,1,1,1,0
Ads & Commerce,India,GLOBALLOGIC INC,APAC,2025-04-29,1,1,0,0,0
Technical Infrastructure,United States,SCHENKER,NORTH AMERICA,2025-04-23,3,3,2,2,0
Technical Infrastructure,Israel,IRON SYSTEMS INC,EMEA,2025-04-23,15,2,13,13,0
Waymo,United States,AUTONATION,NORTH AMERICA,2025-04-29,4,2,2,1,1
Search,India,PWC,APAC,2025-04-24,1,1,0,0,0
REWS,United States,ARAMARK HOLDINGS CORPORATION,NORTH AMERICA,2025-05-01,3,4,0,0,0
gCS,India,ACCENTURE PLC,APAC,2025-04-29,6,2,4,0,4
Geo,India,COGNIZANT TECHNOLOGY SOLUTIONS CORPORATION,APAC,2025-04-23,2,1,1,0,1
T&S,India,WIPRO LIMITED,APAC,2025-04-22,10,6,6,5,1
gCS,Brazil,ATENTO S.A.,LATAM,2025-04-29,3,4,1,1,0
T&S,Philippines,ACCENTURE PLC,APAC,2025-05-02,3,3,0,0,0
Platforms + Ecosystems,India,ITTIAM SYSTEMS PVT LTD,APAC,2025-04-28,6,5,3,0,3
Access,United States,"PROJECT RESOURCES GROUP, INC.",NORTH AMERICA,2025-04-23,9,4,7,6,1
gTech,India,VIRTUSA CORPORATION,APAC,2025-04-25,3,2,1,0,1
T&S,Malaysia,ACCENTURE PLC,APAC,2025-04-23,9,1,8,1,7
Technical Infrastructure,India,ACCENTURE PLC,APAC,2025-04-24,3,3,0,0,0
Cloud,India,COGNIZANT TECHNOLOGY SOLUTIONS CORPORATION,APAC,2025-04-21,1,3,0,0,0
Technical Infrastructure,United States,GXO LOGISTICS WORLDWIDE LLC,NORTH AMERICA,2025-04-24,2,2,0,0,0
Google.org,United States,"TECHNOLOGY RESOURCE SOLUTIONS, INC. D/B/A SYNERGIS (VENDOR)",NORTH AMERICA,2025-04-21,5,2,3,0,3
Technical Infrastructure,India,INDIGO TELECOM GROUP LTD,APAC,2025-04-29,1,1,0,0,0
Technical Infrastructure,United Kingdom,ARCADIS NV,EMEA,2025-04-29,4,1,3,2,1
Geo,Brazil,COGNIZANT TECHNOLOGY SOLUTIONS CORPORATION,LATAM,2025-04-23,6,3,3,2,1
T&S,Philippines,ACCENTURE PLC,APAC,2025-04-30,11,3,8,0,8
REWS,United States,JONES LANG LASALLE INC,NORTH AMERICA,2025-05-01,5,4,3,0,3
Cloud,India,DELOITTE,APAC,2025-04-22,2,3,1,0,1
YouTube,India,CONCENTRIX,APAC,2025-04-21,7,6,3,0,3
gTech,India,HCL TECHNOLOGIES LTD,APAC,2025-04-30,7,2,5,5,0
Technical Infrastructure,null,EVERGREEN JANITORIAL SERVICES INC,NORTH AMERICA,2025-04-22,3,5,0,0,0
T&S,Portugal,ACCENTURE PLC,EMEA,2025-04-30,11,1,10,0,10
YouTube,India,CONCENTRIX,APAC,2025-04-27,4,1,3,1,2
gTech,Poland,TELEPERFORMANCE SE,EMEA,2025-04-28,3,5,0,0,0
Waymo,India,WIPRO LIMITED,APAC,2025-04-30,2,3,0,0,0
gCS,India,ACCENTURE PLC,APAC,2025-04-23,6,2,4,2,2
Technical Infrastructure,null,ERICSSON INC,APAC,2025-04-29,3,5,0,0,0
REWS,India,JONES LANG LASALLE INC,APAC,2025-05-02,3,3,0,0,0
Technical Infrastructure,United States,GARDA WORLD SECURITY CORPORATION,NORTH AMERICA,2025-04-28,4,6,0,0,0
gCS,Brazil,TTEC HOLDINGS INC,LATAM,2025-04-28,4,2,2,1,1
T&S,India,WIPRO LIMITED,APAC,2025-04-25,2,2,0,0,0
Waymo,India,WIPRO LIMITED,APAC,2025-04-30,2,1,1,1,0
Corp Eng,India,MOVATE TECHNOLOGIES PRIVATE LIMITED,APAC,2025-04-21,4,1,3,1,2
Devices & Services,India,MIRAFRA SOFTWARE TECHNOLOGIES PVT. LTD.,APAC,2025-04-21,5,3,2,2,0
REWS,India,COMPASS GROUP PLC,APAC,2025-05-01,3,3,0,0,0
POps,India,KORN FERRY INTERNATIONAL,APAC,2025-04-24,3,2,1,1,0
Global Affairs (w/o T&S),United States,EQUIPMEDIA LTD,NORTH AMERICA,2025-04-30,17,3,14,13,1
T&S,India,ACCENTURE PLC,APAC,2025-04-25,4,3,1,0,1
Geo,India,COGNIZANT TECHNOLOGY SOLUTIONS CORPORATION,APAC,2025-04-28,3,2,1,1,0
T&S,India,WIPRO LIMITED,APAC,2025-04-24,3,1,2,0,2
gCS,India,REGALIX INC,APAC,2025-04-25,4,2,2,2,0
T&S,India,COGNIZANT TECHNOLOGY SOLUTIONS CORPORATION,APAC,2025-04-22,3,1,2,2,0
YouTube,Malaysia,CONCENTRIX,APAC,2025-04-24,7,1,6,6,0
REWS,India,JONES LANG LASALLE INC,APAC,2025-04-23,1,1,0,0,0
Cloud,Malaysia,WEBHELP GROUP,APAC,2025-04-23,1,1,0,0,0
Geo,India,WIPRO LIMITED,APAC,2025-04-28,2,4,0,0,0
Ads & Commerce,United States,"AKRAYA, INC",NORTH AMERICA,2025-04-29,5,3,2,1,1
Waymo,United States,COGNIZANT TECHNOLOGY SOLUTIONS CORPORATION,NORTH AMERICA,2025-04-21,4,3,1,0,1
Waymo,India,WIPRO LIMITED,APAC,2025-04-24,3,4,0,0,0
Technical Infrastructure,India,BRISTLECONE INC.,APAC,2025-04-22,1,1,0,0,0
gTech,India,VIRTUSA CORPORATION,APAC,2025-04-25,3,2,1,0,1
REWS,United States,"INTER-CON SECURITY SYSTEMS, INC.",NORTH AMERICA,2025-04-22,6,3,3,2,1
gTech,India,CONCENTRIX,APAC,2025-04-29,4,5,1,0,1
Global Affairs (w/o T&S),Brazil,ACCENTURE PLC,LATAM,2025-04-25,8,6,4,2,2
POps,India,ACCENTURE PLC,APAC,2025-05-01,4,4,2,0,2
REWS,India,COMPASS GROUP PLC,APAC,2025-04-23,2,2,0,0,0
Cloud,United States,DELOITTE,NORTH AMERICA,2025-04-29,3,5,0,0,0
Devices & Services,India,HCL TECHNOLOGIES LTD,APAC,2025-04-28,3,2,1,0,1
Technical Infrastructure,Canada,SCHENKER,NORTH AMERICA,2025-04-23,14,5,11,10,1
REWS,India,JONES LANG LASALLE INC,APAC,2025-04-25,3,3,0,0,0
Geo,India,ACCENTURE PLC,APAC,2025-04-25,4,3,1,0,1
Technical Infrastructure,United States,SCHENKER,NORTH AMERICA,2025-04-29,1,1,0,0,0
Search,Malaysia,TECH MAHINDRA LIMITED,APAC,2025-04-30,3,5,0,0,0
Ads & Commerce,India,GLOBALLOGIC INC,APAC,2025-04-24,5,7,0,0,0
Devices & Services,Taiwan,WIPRO LIMITED,APAC,2025-04-23,3,3,2,1,1
Corp Eng,India,HCL TECHNOLOGIES LTD,APAC,2025-04-29,2,3,1,0,1
REWS,United States,"INTER-CON SECURITY SYSTEMS, INC.",NORTH AMERICA,2025-04-23,4,5,1,1,0
Technical Infrastructure,United States,DIRECT LINE GLOBAL LLC,NORTH AMERICA,2025-04-22,2,4,0,0,0
REWS,null,MEDIFIT CONSULTANTS PVT LTD,APAC,2025-05-02,3,3,0,0,0
Devices & Services,United States,INSIGHT,NORTH AMERICA,2025-04-22,3,4,1,0,1
Technical Infrastructure,United Kingdom,SYNERGY SECURITY SOLUTIONS LIMITED,EMEA,2025-04-23,5,5,2,1,1
T&S,India,WIPRO LIMITED,APAC,2025-05-02,5,5,2,0,2
Technical Infrastructure,United States,GXO LOGISTICS WORLDWIDE LLC,NORTH AMERICA,2025-04-22,15,3,12,12,0
Devices & Services,Taiwan,TATA GROUP,APAC,2025-04-30,2,null,2,2,0
T&S,Malaysia,ACCENTURE PLC,APAC,2025-04-24,10,4,8,0,8
YouTube,Philippines,TECH MAHINDRA LIMITED,APAC,2025-05-02,11,4,9,4,5
Technical Infrastructure,United States,"ROONEY HOLDINGS, INC.",NORTH AMERICA,2025-05-02,3,3,0,0,0
REWS,India,JONES LANG LASALLE INC,APAC,2025-05-02,3,3,0,0,0
gCS,India,WNS (HOLDINGS) LIMITED,APAC,2025-04-24,3,1,2,1,1
Waymo,India,WIPRO LIMITED,APAC,2025-04-27,4,1,3,0,3
gTech,Philippines,CONCENTRIX,APAC,2025-04-23,2,1,1,1,0
Marketing,Australia,ADECCO GROUP AG,APAC,2025-04-24,23,39,18,18,0
gTech,India,COGNIZANT TECHNOLOGY SOLUTIONS CORPORATION,APAC,2025-05-01,3,3,0,0,0
REWS,United States,"INTER-CON SECURITY SYSTEMS, INC.",NORTH AMERICA,2025-04-21,4,1,3,3,0
gCS,India,ACCENTURE PLC,APAC,2025-04-28,3,2,1,1,0
YouTube,Greece,TELEPERFORMANCE SE,EMEA,2025-05-01,3,3,0,0,0
Cloud,India,CAPGEMINI SE,APAC,2025-05-02,8,1,7,1,6
Global Affairs (w/o T&S),India,ACCENTURE PLC,APAC,2025-04-28,4,2,2,1,1
gTech,India,GLOBALLOGIC INC,APAC,2025-04-25,3,3,0,0,0
DeepMind,United States,SCALE AI INC,NORTH AMERICA,2025-04-22,17,4,15,0,15
Corp Eng,India,IBM CORPORATION,APAC,2025-04-21,2,1,1,0,1
POps,India,RANDSTAD NV,APAC,2025-04-25,11,4,9,7,2
Geo,India,COGNIZANT TECHNOLOGY SOLUTIONS CORPORATION,APAC,2025-05-02,6,4,4,3,1
REWS,null,COMPASS GROUP PLC,NORTH AMERICA,2025-05-01,3,3,0,0,0
Access,United States,DYCOM INDUSTRIES,NORTH AMERICA,2025-04-24,10,5,7,3,4
Technical Infrastructure,Netherlands,ANCHORBUOY LIMITED,EMEA,2025-04-23,6,2,4,4,0
Access,United States,DYCOM INDUSTRIES,NORTH AMERICA,2025-05-01,6,5,3,1,2
Access,Philippines,ACCENTURE PLC,APAC,2025-04-24,14,6,10,0,10
Technical Infrastructure,Netherlands,SYNCREON GLOBAL HOLDINGS LIMITED,EMEA,2025-04-23,8,5,5,4,1
Access,United States,IBEX HOLDINGS LIMITED,NORTH AMERICA,2025-04-22,3,1,2,1,1
REWS,Finland,COMPASS GROUP PLC,EMEA,2025-04-29,2,4,0,0,0
Technical Infrastructure,United States,"HOLDER CONSTRUCTION GROUP, LLC",NORTH AMERICA,2025-04-21,4,6,0,0,0
Waymo,India,WIPRO LIMITED,APAC,2025-04-22,1,2,0,0,0
Technical Infrastructure,null,EVERGREEN JANITORIAL SERVICES INC,NORTH AMERICA,2025-04-25,3,3,0,0,0
REWS,null,THE GASTRONOME LTD,EMEA,2025-04-28,3,5,0,0,0
Waymo,United States,"TASKUS, INC.",NORTH AMERICA,2025-05-02,3,3,0,0,0
T&S,India,WIPRO LIMITED,APAC,2025-04-25,2,1,1,1,0
Corp Eng,India,MOVATE TECHNOLOGIES PRIVATE LIMITED,APAC,2025-04-21,4,2,2,0,2
Access,United States,"PROJECT RESOURCES GROUP, INC.",NORTH AMERICA,2025-04-22,10,7,5,1,4
Platforms + Ecosystems,India,HCL TECHNOLOGIES LTD,APAC,2025-04-30,5,6,1,0,1
gTech,India,VIRTUSA CORPORATION,APAC,2025-04-25,3,2,1,0,1
gTech,India,COGNIZANT TECHNOLOGY SOLUTIONS CORPORATION,APAC,2025-04-25,3,3,0,0,0
YouTube,India,CONCENTRIX,APAC,2025-04-30,3,4,1,0,1
Waymo,India,WIPRO LIMITED,APAC,2025-04-24,3,4,0,0,0
gTech,India,COGNIZANT TECHNOLOGY SOLUTIONS CORPORATION,APAC,2025-04-25,3,2,1,1,0
Waymo,United States,UBER TECHNOLOGIES INC,NORTH AMERICA,2025-04-30,2,2,0,0,0
Access,United States,ACCENTURE PLC,NORTH AMERICA,2025-05-02,4,2,2,0,2
gTech,India,TELEPERFORMANCE SE,APAC,2025-04-22,5,2,3,1,2
T&S,India,WIPRO LIMITED,APAC,2025-05-01,4,5,1,1,0
Technical Infrastructure,India,JAGUAR SECURITY SERVICES PVT. LTD.,APAC,2025-04-21,3,5,0,0,0
YouTube,India,GENPACT LIMITED,APAC,2025-04-25,4,2,2,2,0
Technical Infrastructure,United States,ALLIED UNIVERSAL,NORTH AMERICA,2025-04-24,3,2,1,0,1
T&S,Philippines,ACCENTURE PLC,APAC,2025-04-23,11,2,9,2,7
gCS,India,REGALIX INC,APAC,2025-04-22,3,4,1,1,0
Marketing,United States,LUCKY DAY LLC,NORTH AMERICA,2025-04-24,7,6,3,3,0
Devices & Services,United States,QUEST GLOBAL SERVICES PTE. LTD.,NORTH AMERICA,2025-04-29,3,5,0,0,0
Global Affairs (w/o T&S),United States,AXIOM GLOBAL INC,NORTH AMERICA,2025-05-02,5,3,4,0,4
Cloud,United States,"Probity, Inc",NORTH AMERICA,2025-04-21,2,1,1,0,1
T&S,India,WIPRO LIMITED,APAC,2025-04-21,6,5,3,3,0
REWS,India,COMPASS GROUP PLC,APAC,2025-04-23,2,2,0,0,0
gTech,Guatemala,TELUS,LATAM,2025-04-24,2,1,1,0,1
gTech,India,COGNIZANT TECHNOLOGY SOLUTIONS CORPORATION,APAC,2025-04-22,4,2,2,1,1
Cloud,Costa Rica,SERVICESOURCE INTERNATIONAL INC,LATAM,2025-04-25,3,3,0,0,0
Technical Infrastructure,United States,SYNCREON GLOBAL HOLDINGS LIMITED,NORTH AMERICA,2025-04-22,6,4,2,2,0
gCS,India,REGALIX INC,APAC,2025-04-27,5,3,2,0,2
Cloud,Bulgaria,SERVICESOURCE INTERNATIONAL INC,EMEA,2025-04-28,4,3,1,0,1
Waymo,United States,METRO ONE LOSS PREVENTION SERVICES GROUP (GUARD DIVISION) INC,NORTH AMERICA,2025-04-21,6,5,3,2,1
T&S,India,COGNIZANT TECHNOLOGY SOLUTIONS CORPORATION,APAC,2025-04-25,4,1,3,0,3
Waymo,United States,TRANSDEV,NORTH AMERICA,2025-04-30,2,2,0,0,0
Technical Infrastructure,United States,"HOLDER CONSTRUCTION GROUP, LLC",NORTH AMERICA,2025-04-23,2,2,0,0,0
Waymo,India,WIPRO LIMITED,APAC,2025-04-24,3,2,1,1,0
Technical Infrastructure,United States,ADECCO GROUP AG,NORTH AMERICA,2025-04-21,3,6,0,0,0
Global Affairs (w/o T&S),India,ACCENTURE PLC,APAC,2025-04-29,4,1,3,1,2
Technical Infrastructure,United States,GXO LOGISTICS WORLDWIDE LLC,NORTH AMERICA,2025-05-02,3,3,0,0,0
gCS,Spain,TELEPERFORMANCE SE,EMEA,2025-04-28,4,null,4,3,1
gTech,United States,ACCENTURE PLC,NORTH AMERICA,2025-04-24,2,2,0,0,0
Devices & Services,United States,MOSAIC US HOLDINGS INC,NORTH AMERICA,2025-04-21,8,5,5,2,3
Waymo,India,COGNIZANT TECHNOLOGY SOLUTIONS CORPORATION,APAC,2025-04-22,1,1,0,0,0
Technical Infrastructure,null,JONES LANG LASALLE INC,APAC,2025-04-28,3,5,0,0,0
YouTube,Philippines,TECH MAHINDRA LIMITED,APAC,2025-05-02,11,1,10,1,9
POps,Brazil,KORN FERRY INTERNATIONAL,LATAM,2025-04-25,7,5,4,2,2
T&S,Philippines,ACCENTURE PLC,APAC,2025-04-30,11,3,8,0,8
Technical Infrastructure,null,SATURN PARTNERS LLC,NORTH AMERICA,2025-04-24,3,3,0,0,0
REWS,India,JAGUAR SECURITY SERVICES PVT. LTD.,APAC,2025-04-23,1,1,0,0,0
Technical Infrastructure,Netherlands,SYNCREON GLOBAL HOLDINGS LIMITED,EMEA,2025-04-28,4,2,2,1,1
gTech,India,VIRTUSA CORPORATION,APAC,2025-04-25,3,3,0,0,0
Devices & Services,United States,MOSAIC US HOLDINGS INC,NORTH AMERICA,2025-04-29,11,4,7,5,2
Technical Infrastructure,United States,"HOLDER CONSTRUCTION GROUP, LLC",NORTH AMERICA,2025-04-24,4,6,0,0,0
REWS,Poland,COMPASS GROUP PLC,EMEA,2025-04-28,1,3,0,0,0
Waymo,India,WIPRO LIMITED,APAC,2025-04-28,3,2,1,1,0
gTech,India,COGNIZANT TECHNOLOGY SOLUTIONS CORPORATION,APAC,2025-04-28,2,4,0,0,0
Access,United States,"ALAN PLUMMER ASSOCIATES, INC",NORTH AMERICA,2025-04-28,10,2,8,8,0
Access,India,"CHC CONSULTING, LLC",APAC,2025-04-30,18,6,14,12,2
Waymo,India,COGNIZANT TECHNOLOGY SOLUTIONS CORPORATION,APAC,2025-04-21,1,3,0,0,0
Technical Infrastructure,United States,GXO LOGISTICS WORLDWIDE LLC,NORTH AMERICA,2025-04-28,4,2,2,0,2
gCS,India,ACCENTURE PLC,APAC,2025-04-22,5,2,3,3,0
T&S,Portugal,COGNIZANT TECHNOLOGY SOLUTIONS CORPORATION,EMEA,2025-04-22,6,1,5,4,1
REWS,India,SODEXO,APAC,2025-05-02,3,3,0,0,0
Waymo,India,WIPRO LIMITED,APAC,2025-05-01,3,3,0,0,0
Finance,United States,"DEXIAN, LLC",NORTH AMERICA,2025-04-28,5,7,4,4,0
T&S,India,WIPRO LIMITED,APAC,2025-04-30,4,4,2,0,2
Waymo,United States,"MAGNIT, LLC",NORTH AMERICA,2025-05-02,19,8,17,0,17
T&S,India,COGNIZANT TECHNOLOGY SOLUTIONS CORPORATION,APAC,2025-04-23,2,1,1,0,1
Marketing,United States,ACCENTURE PLC,NORTH AMERICA,2025-04-29,4,2,2,0,2
T&S,Philippines,ACCENTURE PLC,APAC,2025-05-02,7,2,5,1,4
Technical Infrastructure,United States,DIRECT LINE GLOBAL LLC,NORTH AMERICA,2025-04-21,13,19,0,0,0
gTech,Philippines,ALORICA INC,APAC,2025-04-24,11,1,10,10,0
Technical Infrastructure,United States,"APEX INFRASTRUCTURE CONSULTANTS, LLC",NORTH AMERICA,2025-04-28,9,3,6,1,5
Technical Infrastructure,United States,THE WHITING TURNER CONTRACTING COMPANY,NORTH AMERICA,2025-04-22,3,5,0,0,0
T&S,India,ACCENTURE PLC,APAC,2025-05-02,6,6,2,0,2
Health,United States,"MEDAMERICA CONSULTING EMPLOYEES, INC.",NORTH AMERICA,2025-04-23,2,2,0,0,0
REWS,United States,"INTER-CON SECURITY SYSTEMS, INC.",NORTH AMERICA,2025-04-23,4,5,1,1,0
YouTube,Philippines,TECH MAHINDRA LIMITED,APAC,2025-05-02,11,4,9,7,2
Waymo,United States,"MAGNIT, LLC",NORTH AMERICA,2025-04-22,11,7,9,8,1
Finance,United States,KPMG,NORTH AMERICA,2025-05-02,9,2,7,0,7
Technical Infrastructure,United States,GARDA WORLD SECURITY CORPORATION,NORTH AMERICA,2025-04-30,2,2,0,0,0
Waymo,India,WIPRO LIMITED,APAC,2025-04-30,2,1,1,1,0
Technical Infrastructure,Chile,SISTEMAS CONTRA INCENDIOS EUROCOMERCIAL LTDA,LATAM,2025-04-29,4,6,0,0,0
REWS,United Kingdom,WT PARTNERSHIP S PTE LTD,EMEA,2025-04-25,5,6,1,0,1
Waymo,India,WIPRO LIMITED,APAC,2025-04-29,4,1,3,0,3
POps,India,ACCENTURE PLC,APAC,2025-04-21,6,5,3,2,1
gTech,India,TELEPERFORMANCE SE,APAC,2025-04-21,4,1,3,1,2
Cloud,India,DELOITTE,APAC,2025-04-24,4,4,2,2,0
Technical Infrastructure,United States,GXO LOGISTICS WORLDWIDE LLC,NORTH AMERICA,2025-05-02,7,5,4,4,0
Access,United States,INFOGAIN CORPORATION,NORTH AMERICA,2025-04-28,1,3,0,0,0
Waymo,India,WIPRO LIMITED,APAC,2025-04-22,3,1,2,2,0
Ads & Commerce,Philippines,ACCENTURE PLC,APAC,2025-04-21,4,2,2,0,2
Technical Infrastructure,United States,MCFARLAND BUILDING GROUP LLC,NORTH AMERICA,2025-04-21,2,4,0,0,0
Platforms + Ecosystems,India,MARKETSTAR CORPORATION,APAC,2025-04-28,1,3,0,0,0
Waymo,United States,TRANSDEV,NORTH AMERICA,2025-04-25,2,2,0,0,0
Devices & Services,null,TEZERAKT LLC,NORTH AMERICA,2025-04-28,3,5,0,0,0
GBO (w/o gTech & gCS),India,ACCENTURE PLC,APAC,2025-04-29,4,2,2,1,1
Technical Infrastructure,United States,GXO LOGISTICS WORLDWIDE LLC,NORTH AMERICA,2025-04-24,2,2,0,0,0
Technical Infrastructure,null,CRUZ Y DAVILA INGENIEROS CONSULTORES LTDA,LATAM,2025-04-22,9,13,0,0,0
Finance,Mexico,ACCENTURE PLC,LATAM,2025-04-23,4,5,1,1,0
Waymo,United States,"EMBEDDED RESOURCE GROUP, INC.",NORTH AMERICA,2025-05-01,5,4,3,0,3
Ads & Commerce,India,TELEPERFORMANCE SE,APAC,2025-04-23,5,7,0,0,0
POps,India,RANDSTAD NV,APAC,2025-04-28,7,1,6,2,4
Technical Infrastructure,United States,ALLIED UNIVERSAL,NORTH AMERICA,2025-04-22,1,1,0,0,0
Technical Infrastructure,United States,C D MOODY CONSTRUCTION COMPANY INC,NORTH AMERICA,2025-04-24,3,3,0,0,0
Technical Infrastructure,United States,GXO LOGISTICS WORLDWIDE LLC,NORTH AMERICA,2025-04-25,8,2,6,6,0
Cloud,India,"SYNOPSYS, INC",APAC,2025-04-25,6,5,3,3,0
gCS,India,ACCENTURE PLC,APAC,2025-04-28,9,3,6,3,3
Technical Infrastructure,United States,SATURN PARTNERS LLC,NORTH AMERICA,2025-04-23,2,2,0,0,0
Geo,India,COGNIZANT TECHNOLOGY SOLUTIONS CORPORATION,APAC,2025-04-28,3,1,2,0,2
gTech,India,GENPACT LIMITED,APAC,2025-04-22,6,3,3,2,1
Technical Infrastructure,United Kingdom,SYNERGY SECURITY SOLUTIONS LIMITED,EMEA,2025-04-24,2,2,0,0,0
Technical Infrastructure,Netherlands,SYNCREON GLOBAL HOLDINGS LIMITED,EMEA,2025-04-22,7,4,5,5,0
gTech,India,COGNIZANT TECHNOLOGY SOLUTIONS CORPORATION,APAC,2025-04-21,4,2,2,2,0
Marketing,United States,"ARTECH INFORMATION SYSTEMS, LLC",NORTH AMERICA,2025-04-27,2,5,0,0,0
YouTube,India,CONCENTRIX,APAC,2025-04-21,3,2,1,0,1
Waymo,United States,TRANSDEV,NORTH AMERICA,2025-05-02,8,2,6,0,6
Cloud,Philippines,ACCENTURE PLC,APAC,2025-04-25,11,5,8,5,3
Cloud,United States,GLOBALLOGIC INC,NORTH AMERICA,2025-04-24,1,1,0,0,0
gTech,India,TELEPERFORMANCE SE,APAC,2025-04-28,5,4,1,1,0
Devices & Services,India,HCL TECHNOLOGIES LTD,APAC,2025-04-23,2,2,0,0,0
Technical Infrastructure,null,TW CONSTRUCTORS LLC,NORTH AMERICA,2025-04-22,3,5,0,0,0
POps,India,RANDSTAD NV,APAC,2025-05-02,7,5,4,4,0
Ads & Commerce,United States,"ANSWERLAB, LLC",NORTH AMERICA,2025-05-02,3,3,0,0,0
YouTube,India,CONCENTRIX,APAC,2025-04-21,4,1,3,1,2
REWS,United States,JONES LANG LASALLE INC,NORTH AMERICA,2025-04-25,3,3,0,0,0
Technical Infrastructure,United States,SCHENKER,NORTH AMERICA,2025-04-25,2,2,0,0,0
T&S,Ireland,ACCENTURE PLC,EMEA,2025-05-02,6,4,4,0,4
Technical Infrastructure,United States,SCHENKER,NORTH AMERICA,2025-04-29,6,2,4,0,4
Technical Infrastructure,Finland,GXO LOGISTICS WORLDWIDE LLC,EMEA,2025-04-22,5,1,4,3,1
YouTube,India,CONCENTRIX,APAC,2025-04-22,4,5,1,1,0
gTech,United States,VACO,NORTH AMERICA,2025-04-21,3,2,1,0,1
T&S,India,WIPRO LIMITED,APAC,2025-05-01,6,7,1,0,1
Technical Infrastructure,null,TW CONSTRUCTORS LLC,NORTH AMERICA,2025-04-22,3,5,0,0,0
Technical Infrastructure,United States,GXO LOGISTICS WORLDWIDE LLC,NORTH AMERICA,2025-04-23,11,3,8,8,0
T&S,India,COGNIZANT TECHNOLOGY SOLUTIONS CORPORATION,APAC,2025-04-25,4,1,3,0,3
Devices & Services,United States,MOSAIC US HOLDINGS INC,NORTH AMERICA,2025-04-25,4,1,3,1,2
Technical Infrastructure,null,"ROONEY HOLDINGS, INC.",NORTH AMERICA,2025-05-01,3,3,0,0,0
Cloud,Mexico,HCL TECHNOLOGIES LTD,LATAM,2025-04-28,5,4,1,0,1
Technical Infrastructure,United States,TW CONSTRUCTORS LLC,NORTH AMERICA,2025-04-21,2,4,0,0,0
YouTube,India,ACCENTURE PLC,APAC,2025-05-02,6,4,4,0,4
Ads & Commerce,United States,"MAGNIT, LLC",NORTH AMERICA,2025-05-01,11,9,9,1,8
Technical Infrastructure,Singapore,NIPPON TELEGRAPH AND TELEPHONE CORPORATION,APAC,2025-04-24,2,2,0,0,0
Technical Infrastructure,Netherlands,SYNCREON GLOBAL HOLDINGS LIMITED,EMEA,2025-04-28,3,1,2,1,1
gTech,India,COGNIZANT TECHNOLOGY SOLUTIONS CORPORATION,APAC,2025-04-25,3,2,1,0,1
REWS,India,G4S PLC,APAC,2025-04-24,1,1,0,0,0
gCS,India,REGALIX INC,APAC,2025-04-25,4,3,1,1,0
Technical Infrastructure,null,INTEGRITY CONCEPTS LLC,NORTH AMERICA,2025-04-21,3,5,0,0,0
Geo,India,COGNIZANT TECHNOLOGY SOLUTIONS CORPORATION,APAC,2025-05-02,6,6,2,2,0
Devices & Services,India,HCL TECHNOLOGIES LTD,APAC,2025-04-23,2,2,0,0,0
Search,India,ACCENTURE PLC,APAC,2025-04-22,3,4,1,1,0
Waymo,India,COGNIZANT TECHNOLOGY SOLUTIONS CORPORATION,APAC,2025-04-21,1,3,0,0,0
Ads & Commerce,India,TELEPERFORMANCE SE,APAC,2025-04-23,5,7,0,0,0
Platforms + Ecosystems,United States,MIRAFRA SOFTWARE TECHNOLOGIES PVT. LTD.,NORTH AMERICA,2025-04-27,6,6,2,0,2
Waymo,United States,METRO ONE LOSS PREVENTION SERVICES GROUP (GUARD DIVISION) INC,NORTH AMERICA,2025-04-24,10,5,7,4,3
gTech,null,TELEPERFORMANCE SE,EMEA,2025-04-28,3,5,0,0,0
YouTube,India,WIPRO LIMITED,APAC,2025-04-24,3,2,2,2,0
Corp Eng,India,MOVATE TECHNOLOGIES PRIVATE LIMITED,APAC,2025-04-21,4,1,3,0,3
Technical Infrastructure,United States,VISION TECHNOLOGIES INC.,NORTH AMERICA,2025-04-24,2,1,1,1,0
Devices & Services,Germany,ADECCO GROUP AG,EMEA,2025-04-24,11,140,7,7,0
gTech,India,VIRTUSA CORPORATION,APAC,2025-04-25,3,2,1,0,1
gTech,Portugal,TELEPERFORMANCE SE,EMEA,2025-04-21,6,3,5,5,0
POps,India,RANDSTAD NV,APAC,2025-04-29,13,5,10,2,8
Devices & Services,India,TESSOLVE SEMICONDUCTOR PVT LTD,APAC,2025-05-02,3,3,0,0,0
Technical Infrastructure,United States,DIRECT LINE GLOBAL LLC,NORTH AMERICA,2025-04-22,2,4,0,0,0
T&S,Portugal,COGNIZANT TECHNOLOGY SOLUTIONS CORPORATION,EMEA,2025-04-23,5,2,3,1,2
gTech,India,VIRTUSA CORPORATION,APAC,2025-04-27,4,2,2,1,1
Technical Infrastructure,United States,"HOLDER CONSTRUCTION GROUP, LLC",NORTH AMERICA,2025-05-02,3,3,0,0,0
Waymo,India,COGNIZANT TECHNOLOGY SOLUTIONS CORPORATION,APAC,2025-04-24,2,2,0,0,0
Core (w/o Corp Eng),United States,NCC GROUP,NORTH AMERICA,2025-05-01,14,5,11,10,1
gTech,Colombia,CONCENTRIX,LATAM,2025-04-30,3,4,1,0,1
YouTube,India,GENPACT LIMITED,APAC,2025-04-28,3,2,1,1,0
gTech,India,TELEPERFORMANCE SE,APAC,2025-04-22,6,3,3,2,1
T&S,India,WIPRO LIMITED,APAC,2025-04-28,4,1,3,3,0
gCS,India,TELEDIRECT PTE LTD,APAC,2025-04-21,9,2,7,0,7
Waymo,India,WIPRO LIMITED,APAC,2025-04-30,2,2,0,0,0
Technical Infrastructure,Singapore,GXO LOGISTICS WORLDWIDE LLC,APAC,2025-04-24,3,2,1,0,1
gTech,India,TELEPERFORMANCE SE,APAC,2025-04-23,6,2,4,1,3
gTech,Malaysia,TELEDIRECT PTE LTD,APAC,2025-04-28,2,4,0,0,0
Waymo,India,COGNIZANT TECHNOLOGY SOLUTIONS CORPORATION,APAC,2025-04-23,3,3,2,0,2
YouTube,India,ACCENTURE PLC,APAC,2025-04-21,8,2,6,0,6
Cloud,United States,GLOBALLOGIC INC,NORTH AMERICA,2025-04-24,1,1,0,0,0
Technical Infrastructure,United States,VIKING ENGINEERING AND CONSTRUCTION LLC,NORTH AMERICA,2025-04-29,11,3,8,6,2
Technical Infrastructure,United States,SYNCREON GLOBAL HOLDINGS LIMITED,NORTH AMERICA,2025-04-23,10,5,7,7,0
Cloud,India,VIRTUSA CORPORATION,APAC,2025-04-28,2,4,0,0,0
Technical Infrastructure,United States,ALLIED UNIVERSAL,NORTH AMERICA,2025-05-01,8,2,6,6,0
Cloud,Mexico,EPAM SYSTEMS INC,LATAM,2025-04-21,5,2,3,1,2
REWS,Romania,CBRE GROUP INC,EMEA,2025-05-02,3,3,0,0,0
Access,United States,DYCOM INDUSTRIES,NORTH AMERICA,2025-04-25,3,1,2,1,1
gTech,India,GENPACT LIMITED,APAC,2025-04-24,1,1,0,0,0
gTech,India,VIRTUSA CORPORATION,APAC,2025-04-28,4,3,1,1,0
gCS,Philippines,CONCENTRIX,APAC,2025-05-01,3,2,1,1,0
T&S,India,WIPRO LIMITED,APAC,2025-04-27,4,3,1,0,1
POps,India,RANDSTAD NV,APAC,2025-04-25,11,1,10,2,8
gTech,India,COGNIZANT TECHNOLOGY SOLUTIONS CORPORATION,APAC,2025-05-01,3,3,0,0,0
T&S,India,COGNIZANT TECHNOLOGY SOLUTIONS CORPORATION,APAC,2025-04-21,1,3,0,0,0
T&S,Portugal,ACCENTURE PLC,EMEA,2025-04-29,10,1,9,0,9
Platforms + Ecosystems,Philippines,ACCENTURE PLC,APAC,2025-05-01,10,6,6,3,3
Technical Infrastructure,United States,GXO LOGISTICS WORLDWIDE LLC,NORTH AMERICA,2025-04-25,11,4,9,5,4
Technical Infrastructure,India,BRISTLECONE INC.,APAC,2025-04-24,3,2,1,0,1
Waymo,India,COGNIZANT TECHNOLOGY SOLUTIONS CORPORATION,APAC,2025-04-23,1,1,0,0,0
Technical Infrastructure,United States,GXO LOGISTICS WORLDWIDE LLC,NORTH AMERICA,2025-04-25,3,2,1,0,1
YouTube,United States,TELEPERFORMANCE SE,NORTH AMERICA,2025-04-30,4,4,2,2,0
REWS,France,CBRE GROUP INC,EMEA,2025-04-22,5,7,0,0,0
Devices & Services,India,SMOLLAN GROUP SA PTY LTD,APAC,2025-04-23,13,5,10,1,9
gTech,India,TELEPERFORMANCE SE,APAC,2025-04-22,5,1,4,0,4
Waymo,India,WIPRO LIMITED,APAC,2025-04-24,3,4,0,0,0
T&S,Philippines,ACCENTURE PLC,APAC,2025-04-29,10,6,6,1,5
Technical Infrastructure,United States,"HOLDER CONSTRUCTION GROUP, LLC",NORTH AMERICA,2025-04-30,2,2,0,0,0
T&S,India,WIPRO LIMITED,APAC,2025-05-01,4,5,1,0,1
T&S,Philippines,ACCENTURE PLC,APAC,2025-05-02,7,2,5,0,5
Geo,India,WIPRO LIMITED,APAC,2025-04-23,2,1,1,0,1
Technical Infrastructure,United States,ALLIED UNIVERSAL,NORTH AMERICA,2025-04-28,4,2,2,0,2
Technical Infrastructure,null,SISTEMAS CONTRA INCENDIOS EUROCOMERCIAL LTDA,LATAM,2025-04-28,3,5,0,0,0
Technical Infrastructure,United States,C D MOODY CONSTRUCTION COMPANY INC,NORTH AMERICA,2025-04-24,3,3,0,0,0
gTech,India,GENPACT LIMITED,APAC,2025-04-24,3,3,0,0,0
YouTube,United States,ZENITH TALENT CORPORATION,NORTH AMERICA,2025-05-02,6,7,3,0,3
gTech,India,COGNIZANT TECHNOLOGY SOLUTIONS CORPORATION,APAC,2025-04-22,3,1,2,1,1
gTech,United States,VACO,NORTH AMERICA,2025-04-21,3,2,1,0,1
Waymo,United States,TRANSDEV,NORTH AMERICA,2025-05-02,8,6,4,0,4
Marketing,United Kingdom,ADECCO UK LIMITED,EMEA,2025-04-25,7,7,4,0,4
Technical Infrastructure,Philippines,ACCENTURE PLC,APAC,2025-04-24,1,1,0,0,0
YouTube,India,CONCENTRIX,APAC,2025-04-21,4,2,2,2,0
REWS,India,JONES LANG LASALLE INC,APAC,2025-04-22,1,1,0,0,0
Access,United States,HR GREEN INC,NORTH AMERICA,2025-04-21,19,8,13,12,1
gTech,Poland,TELEPERFORMANCE SE,EMEA,2025-04-28,3,5,0,0,0
Technical Infrastructure,null,"ROONEY HOLDINGS, INC.",NORTH AMERICA,2025-05-01,3,3,0,0,0
Cloud,Chile,GLOBANT LLC,LATAM,2025-04-24,2,1,1,0,1
YouTube,India,ACCENTURE PLC,APAC,2025-05-02,6,4,4,0,4
Technical Infrastructure,null,EVERGREEN JANITORIAL SERVICES INC,NORTH AMERICA,2025-04-25,3,3,0,0,0
YouTube,India,CONCENTRIX,APAC,2025-04-24,5,5,2,0,2
Technical Infrastructure,United States,GXO LOGISTICS WORLDWIDE LLC,NORTH AMERICA,2025-04-21,4,2,2,1,1
Cloud,United States,GLOBALLOGIC INC,NORTH AMERICA,2025-05-02,4,3,1,0,1
Cloud,India,INFOSYS,APAC,2025-04-23,3,null,3,0,3
gTech,Philippines,CONCENTRIX,APAC,2025-04-28,7,5,4,0,4
POps,United States,DELOITTE,NORTH AMERICA,2025-04-29,4,2,2,0,2
gCS,China,TELEDIRECT PTE LTD,APAC,2025-04-27,11,5,8,3,5
gTech,Philippines,TELUS,APAC,2025-04-23,3,4,1,0,1
Waymo,United States,METRO ONE LOSS PREVENTION SERVICES GROUP (GUARD DIVISION) INC,NORTH AMERICA,2025-04-28,4,1,3,0,3
gCS,Spain,TELEPERFORMANCE SE,EMEA,2025-04-22,8,6,4,4,0
gTech,Greece,TELEPERFORMANCE SE,EMEA,2025-04-22,9,5,6,0,6
gTech,Ghana,CONCENTRIX,EMEA,2025-04-22,2,3,1,0,1
Technical Infrastructure,United States,"SBM MANAGEMENT SERVICES, LP",NORTH AMERICA,2025-04-23,1,1,0,0,0
POps,India,RANDSTAD NV,APAC,2025-05-01,11,1,10,7,3
Technical Infrastructure,Canada,ALLIED UNIVERSAL,NORTH AMERICA,2025-04-25,3,2,1,0,1
T&S,India,WIPRO LIMITED,APAC,2025-04-25,8,2,6,1,5
Technical Infrastructure,United States,J E DUNN CONSTRUCTION COMPANY,NORTH AMERICA,2025-04-28,1,3,0,0,0
Technical Infrastructure,United States,FORTIS CONSTRUCTION INC,NORTH AMERICA,2025-04-29,11,2,9,1,8
Cloud,India,COGNIZANT TECHNOLOGY SOLUTIONS CORPORATION,APAC,2025-04-21,4,3,1,0,1
REWS,null,PROPARK AMERICA WEST LLC,NORTH AMERICA,2025-04-29,3,5,0,0,0
Technical Infrastructure,null,"ROONEY HOLDINGS, INC.",NORTH AMERICA,2025-04-29,3,5,0,0,0
POps,India,RANDSTAD NV,APAC,2025-04-25,11,1,10,1,9
gTech,India,TELEPERFORMANCE SE,APAC,2025-04-21,4,2,2,2,0
YouTube,India,ACCENTURE PLC,APAC,2025-05-02,6,4,4,0,4
Geo,India,ACCENTURE PLC,APAC,2025-04-21,12,1,11,1,10
YouTube,India,ACCENTURE PLC,APAC,2025-04-24,5,4,3,1,2
Devices & Services,India,QUEST GLOBAL SERVICES PTE. LTD.,APAC,2025-04-29,3,5,0,0,0
REWS,United States,ELECTROSONIC LIMITED,NORTH AMERICA,2025-04-28,3,5,0,0,0
POps,Taiwan,FAR EASTERN MEMORIAL HOSPITAL,APAC,2025-04-29,2,4,0,0,0
Technical Infrastructure,United States,"HOLDER CONSTRUCTION GROUP, LLC",NORTH AMERICA,2025-04-29,3,5,0,0,0
Access,India,EPAM SYSTEMS INC,APAC,2025-05-02,3,3,0,0,0
Technical Infrastructure,United States,GXO LOGISTICS WORLDWIDE LLC,NORTH AMERICA,2025-05-02,16,4,14,10,4
Technical Infrastructure,United States,THE WHITING TURNER CONTRACTING COMPANY,NORTH AMERICA,2025-04-29,8,6,4,0,4
T&S,India,WIPRO LIMITED,APAC,2025-04-25,4,4,0,0,0
gTech,India,VACO,APAC,2025-04-28,4,1,3,0,3
gCS,India,WNS (HOLDINGS) LIMITED,APAC,2025-04-25,4,3,1,1,0
Technical Infrastructure,Netherlands,SECURITAS AB,EMEA,2025-05-01,7,1,6,5,1
Technical Infrastructure,United States,ADECCO GROUP AG,NORTH AMERICA,2025-04-28,12,6,8,8,0
T&S,Philippines,ACCENTURE PLC,APAC,2025-04-22,10,3,7,1,6
Cloud,United States,ACCENTURE PLC,NORTH AMERICA,2025-04-22,10,3,7,0,7
T&S,India,ACCENTURE PLC,APAC,2025-04-21,2,4,0,0,0
Cloud,Mexico,TATA GROUP,LATAM,2025-04-29,3,4,1,0,1
Technical Infrastructure,United States,"CBM OF AMERICA, INC. (VENDOR)",NORTH AMERICA,2025-04-22,4,5,1,1,0
gTech,Philippines,TELUS,APAC,2025-04-23,3,4,1,0,1
Technical Infrastructure,null,"HOLDER CONSTRUCTION GROUP, LLC",NORTH AMERICA,2025-04-25,3,3,0,0,0
gTech,Poland,TELEPERFORMANCE SE,EMEA,2025-04-21,3,5,0,0,0
Technical Infrastructure,Finland,ADECCO GROUP AG,EMEA,2025-04-28,8,6,5,4,1
Technical Infrastructure,Netherlands,SECURITAS AB,EMEA,2025-04-30,6,1,5,5,0
Technical Infrastructure,United States,SCHENKER,NORTH AMERICA,2025-04-21,2,4,0,0,0
Technical Infrastructure,United States,"HOLDER CONSTRUCTION GROUP, LLC",NORTH AMERICA,2025-04-22,2,4,0,0,0
gTech,India,COGNIZANT TECHNOLOGY SOLUTIONS CORPORATION,APAC,2025-04-30,2,1,1,1,0
Cloud,India,HCL TECHNOLOGIES LTD,APAC,2025-04-23,9,4,7,2,5
T&S,India,WIPRO LIMITED,APAC,2025-04-27,4,1,3,1,2
Cloud,United States,"Probity, Inc",NORTH AMERICA,2025-04-25,6,4,4,2,2
Waymo,United States,MAGNA INTERNATIONAL INC.,NORTH AMERICA,2025-04-24,3,3,0,0,0
Technical Infrastructure,null,NIPPON TELEGRAPH AND TELEPHONE CORPORATION,APAC,2025-04-26,4,4,0,0,0
Cloud,United States,MANTECH ADVANCED SYSTEMS INTERNATIONAL INC,NORTH AMERICA,2025-04-30,2,3,0,0,0
T&S,India,COGNIZANT TECHNOLOGY SOLUTIONS CORPORATION,APAC,2025-04-24,3,1,2,2,0
REWS,Canada,COMPASS GROUP PLC,NORTH AMERICA,2025-04-30,2,2,0,0,0
Waymo,India,COGNIZANT TECHNOLOGY SOLUTIONS CORPORATION,APAC,2025-04-23,1,1,0,0,0
Waymo,India,COGNIZANT TECHNOLOGY SOLUTIONS CORPORATION,APAC,2025-04-21,1,3,0,0,0
Technical Infrastructure,Austria,DREES AND SOMMER SE,EMEA,2025-04-21,5,3,2,0,2
Global Communications & Public Affairs,United States,"MAGNIT, LLC",NORTH AMERICA,2025-04-25,6,6,3,0,3
YouTube,Ireland,ACCENTURE PLC,EMEA,2025-04-23,5,5,2,1,1
Technical Infrastructure,United Kingdom,GXO LOGISTICS WORLDWIDE LLC,EMEA,2025-04-23,6,2,4,0,4
gCS,India,REGALIX INC,APAC,2025-04-25,4,3,1,1,0
Waymo,India,WIPRO LIMITED,APAC,2025-05-01,3,3,0,0,0
gTech,India,VIRTUSA CORPORATION,APAC,2025-04-25,3,2,1,0,1
Cloud,El Salvador,TELUS,LATAM,2025-04-30,2,2,0,0,0
YouTube,India,ACCENTURE PLC,APAC,2025-05-02,6,4,4,0,4
Technical Infrastructure,United States,GXO LOGISTICS WORLDWIDE LLC,NORTH AMERICA,2025-04-29,5,3,2,1,1
Geo,India,WIPRO LIMITED,APAC,2025-04-25,2,2,0,0,0
REWS,United States,JONES LANG LASALLE INC,NORTH AMERICA,2025-04-29,4,2,2,0,2
Corp Eng,India,IBM CORPORATION,APAC,2025-04-23,4,4,2,1,1
Technical Infrastructure,United States,GXO LOGISTICS WORLDWIDE LLC,NORTH AMERICA,2025-05-01,7,6,3,2,1
gTech,Poland,TELEPERFORMANCE SE,EMEA,2025-04-28,3,5,0,0,0
REWS,null,GREATER THAN THE SUM,NORTH AMERICA,2025-05-02,3,3,0,0,0
gTech,India,COGNIZANT TECHNOLOGY SOLUTIONS CORPORATION,APAC,2025-04-23,2,2,0,0,0
T&S,India,COGNIZANT TECHNOLOGY SOLUTIONS CORPORATION,APAC,2025-04-23,3,3,2,2,0
gTech,Colombia,CONCENTRIX,LATAM,2025-04-29,2,4,0,0,0
Global Affairs (w/o T&S),Philippines,ACCENTURE PLC,APAC,2025-04-27,5,4,1,0,1
Waymo,null,METRO ONE LOSS PREVENTION SERVICES GROUP (GUARD DIVISION) INC,NORTH AMERICA,2025-04-29,3,5,0,0,0
Technical Infrastructure,United States,SYNCREON GLOBAL HOLDINGS LIMITED,NORTH AMERICA,2025-04-22,3,1,2,1,1
gTech,India,HCL TECHNOLOGIES LTD,APAC,2025-04-28,5,3,2,0,2
Technical Infrastructure,United States,ALLIED UNIVERSAL,NORTH AMERICA,2025-05-02,3,3,0,0,0
Waymo,India,WIPRO LIMITED,APAC,2025-04-30,2,2,0,0,0
Technical Infrastructure,Finland,FIBER HIGHWAY FINLAND OY,EMEA,2025-04-29,3,5,0,0,0
T&S,India,WIPRO LIMITED,APAC,2025-04-30,3,3,2,0,2
REWS,United States,ELECTROSONIC LIMITED,NORTH AMERICA,2025-04-28,3,5,0,0,0
Global Affairs (w/o T&S),Brazil,"LEE, BROCK, CAMARGO ADVOGADOS",LATAM,2025-04-30,5,2,3,3,0
gTech,Portugal,MAJOREL GLOBAL,EMEA,2025-04-30,7,2,5,5,0
Waymo,India,WIPRO LIMITED,APAC,2025-04-24,3,2,2,2,0
Cloud,United States,GLOBALLOGIC INC,NORTH AMERICA,2025-04-28,3,5,0,0,0
Devices & Services,India,WIPRO LIMITED,APAC,2025-04-28,5,3,2,0,2
POps,United States,"SEDGWICK CLAIMS MANAGEMENT SERVICES, INC.",NORTH AMERICA,2025-04-23,3,4,1,1,0
Technical Infrastructure,United States,GXO LOGISTICS WORLDWIDE LLC,NORTH AMERICA,2025-04-24,2,2,0,0,0
POps,India,ACCENTURE PLC,APAC,2025-04-30,11,1,10,4,6
REWS,Japan,COMPASS GROUP PLC,APAC,2025-04-25,3,3,0,0,0
Corp Eng,India,MOVATE TECHNOLOGIES PRIVATE LIMITED,APAC,2025-04-21,4,1,3,0,3
gCS,India,COGNIZANT TECHNOLOGY SOLUTIONS CORPORATION,APAC,2025-04-23,2,1,1,0,1
Technical Infrastructure,United States,GXO LOGISTICS WORLDWIDE LLC,NORTH AMERICA,2025-05-02,3,3,0,0,0
Waymo,India,COGNIZANT TECHNOLOGY SOLUTIONS CORPORATION,APAC,2025-04-24,2,1,1,0,1
POps,India,RANDSTAD NV,APAC,2025-04-25,10,5,7,3,4
REWS,United States,COMPASS GROUP PLC,NORTH AMERICA,2025-04-30,2,2,0,0,0
Technical Infrastructure,United States,AMENTUM COMMERCIAL OPERATIONS INC,NORTH AMERICA,2025-04-30,2,2,0,0,0
Cloud,India,EPAM SYSTEMS INC,APAC,2025-04-22,2,4,0,0,0
gCS,Spain,TELEPERFORMANCE SE,EMEA,2025-04-25,8,3,5,4,1
T&S,India,WIPRO LIMITED,APAC,2025-04-30,5,2,3,0,3
REWS,India,SIMPLIWORK OFFICES PRIVATE LIMITED,APAC,2025-04-24,1,1,0,0,0
T&S,India,WIPRO LIMITED,APAC,2025-04-29,5,2,3,2,1
REWS,United States,"AVICADO CONSTRUCTION TECHNOLOGY SERVICES, LLC",NORTH AMERICA,2025-04-23,10,5,7,6,1
REWS,United States,GARDA WORLD SECURITY CORPORATION,NORTH AMERICA,2025-05-02,8,2,6,5,1
Wing,United States,TALENTFUL LIMITED,NORTH AMERICA,2025-04-28,4,1,3,1,2
Cloud,India,HCL TECHNOLOGIES LTD,APAC,2025-05-02,3,3,0,0,0
Technical Infrastructure,United States,WEEKS GRP LLC,NORTH AMERICA,2025-04-25,7,2,5,5,0
T&S,India,WIPRO LIMITED,APAC,2025-05-02,3,3,0,0,0
Technical Infrastructure,null,"HOLDER CONSTRUCTION GROUP, LLC",NORTH AMERICA,2025-04-25,3,3,0,0,0
Technical Infrastructure,United States,THE WHITING TURNER CONTRACTING COMPANY,NORTH AMERICA,2025-04-22,3,5,0,0,0
POps,France,WIPRO LIMITED,EMEA,2025-04-29,20,3,17,0,17
Waymo,United States,AMERIT FLEET SOLUTIONS INC.,NORTH AMERICA,2025-04-30,3,4,1,1,0
YouTube,Portugal,COGNIZANT TECHNOLOGY SOLUTIONS CORPORATION,EMEA,2025-04-22,6,3,3,2,1
Platforms + Ecosystems,India,COGNIZANT TECHNOLOGY SOLUTIONS CORPORATION,APAC,2025-04-28,2,4,0,0,0
YouTube,India,GENPACT LIMITED,APAC,2025-04-29,4,2,2,1,1
Geo,Poland,EXECUTE APPS LTD,EMEA,2025-04-28,9,2,7,1,6
T&S,India,CONCENTRIX,APAC,2025-05-02,5,5,2,2,0
YouTube,Philippines,TECH MAHINDRA LIMITED,APAC,2025-04-23,8,3,7,6,1
Technical Infrastructure,Australia,MSS SECURITY PTY LTD,APAC,2025-04-21,4,2,2,2,0
REWS,null,G4S PLC,LATAM,2025-04-25,3,3,0,0,0
Waymo,United States,UBER TECHNOLOGIES INC,NORTH AMERICA,2025-04-30,2,2,0,0,0
YouTube,India,GENPACT LIMITED,APAC,2025-04-28,3,2,1,0,1
gTech,Portugal,CONCENTRIX,EMEA,2025-04-22,20,3,17,5,12
Waymo,India,COGNIZANT TECHNOLOGY SOLUTIONS CORPORATION,APAC,2025-04-21,1,3,0,0,0
POps,India,RANDSTAD NV,APAC,2025-04-28,3,5,0,0,0
Technical Infrastructure,United States,GXO LOGISTICS WORLDWIDE LLC,NORTH AMERICA,2025-04-24,2,2,0,0,0
Waymo,India,WIPRO LIMITED,APAC,2025-04-24,3,4,0,0,0
gCS,India,ACCENTURE PLC,APAC,2025-04-21,10,1,9,0,9
REWS,null,SODEXO,APAC,2025-05-02,3,3,0,0,0
REWS,India,COMPASS GROUP PLC,APAC,2025-04-25,2,2,0,0,0
REWS,India,JONES LANG LASALLE INC,APAC,2025-04-23,2,2,0,0,0
YouTube,India,ACCENTURE PLC,APAC,2025-05-02,6,5,3,3,0
gTech,Philippines,CONCENTRIX,APAC,2025-04-21,11,3,10,6,4
T&S,India,ACCENTURE PLC,APAC,2025-04-28,5,2,3,0,3
REWS,Taiwan,JONES LANG LASALLE INC,APAC,2025-04-21,4,6,0,0,0
Access,United States,"GARY D. NELSON ASSOCIATES, INC.",NORTH AMERICA,2025-05-01,4,8,1,0,1
Waymo,India,COGNIZANT TECHNOLOGY SOLUTIONS CORPORATION,APAC,2025-04-21,1,3,0,0,0
Global Affairs (w/o T&S),United States,VACO,NORTH AMERICA,2025-04-29,4,5,1,0,1
T&S,India,WIPRO LIMITED,APAC,2025-04-25,3,1,2,0,2
Platforms + Ecosystems,India,ITTIAM SYSTEMS PVT LTD,APAC,2025-04-28,6,5,3,1,2
gTech,India,TELEPERFORMANCE SE,APAC,2025-04-25,2,1,1,0,1
Technical Infrastructure,United States,GXO LOGISTICS WORLDWIDE LLC,NORTH AMERICA,2025-05-01,7,3,4,3,1
YouTube,Portugal,GENPACT LIMITED,EMEA,2025-04-22,4,1,3,2,1
POps,India,RANDSTAD NV,APAC,2025-04-29,9,2,7,1,6
Technical Infrastructure,United States,"HOLDER CONSTRUCTION GROUP, LLC",NORTH AMERICA,2025-04-22,3,5,0,0,0
REWS,Canada,GARDA WORLD SECURITY CORPORATION,NORTH AMERICA,2025-04-25,3,2,1,1,0
REWS,India,JONES LANG LASALLE INC,APAC,2025-05-02,3,3,0,0,0
T&S,Portugal,COGNIZANT TECHNOLOGY SOLUTIONS CORPORATION,EMEA,2025-04-22,6,3,3,2,1
Technical Infrastructure,null,"HOLDER CONSTRUCTION GROUP, LLC",NORTH AMERICA,2025-04-25,3,3,0,0,0
gTech,India,COGNIZANT TECHNOLOGY SOLUTIONS CORPORATION,APAC,2025-04-22,2,4,0,0,0
gTech,India,GENPACT LIMITED,APAC,2025-04-29,3,5,0,0,0
Technical Infrastructure,United States,GXO LOGISTICS WORLDWIDE LLC,NORTH AMERICA,2025-04-21,4,3,1,0,1
REWS,India,JONES LANG LASALLE INC,APAC,2025-04-22,1,1,0,0,0
T&S,India,WIPRO LIMITED,APAC,2025-04-25,2,1,1,0,1
Technical Infrastructure,United States,J E DUNN CONSTRUCTION COMPANY,NORTH AMERICA,2025-05-02,3,3,0,0,0
gTech,India,CONCENTRIX,APAC,2025-04-29,4,5,1,0,1
Search,Malaysia,TECH MAHINDRA LIMITED,APAC,2025-04-30,3,5,0,0,0
Marketing,Australia,ALGOMARKETING LTD,APAC,2025-04-30,9,6,5,3,2
REWS,United Kingdom,CBRE GROUP INC,EMEA,2025-04-25,11,1,10,1,9
YouTube,India,ACCENTURE PLC,APAC,2025-05-02,6,5,3,3,0
REWS,United States,COMPASS GROUP PLC,NORTH AMERICA,2025-04-30,2,2,0,0,0
Waymo,India,COGNIZANT TECHNOLOGY SOLUTIONS CORPORATION,APAC,2025-04-21,1,3,0,0,0
Global Affairs (w/o T&S),United States,"CONSILIO, INC",NORTH AMERICA,2025-04-28,7,6,3,2,1
Technical Infrastructure,United States,GXO LOGISTICS WORLDWIDE LLC,NORTH AMERICA,2025-04-24,2,2,0,0,0
Technical Infrastructure,null,SISTEMAS CONTRA INCENDIOS EUROCOMERCIAL LTDA,LATAM,2025-04-28,3,5,0,0,0
REWS,null,ARAMARK HOLDINGS CORPORATION,NORTH AMERICA,2025-05-01,3,4,0,0,0
REWS,null,SODEXO,APAC,2025-05-02,3,3,0,0,0
YouTube,India,CONCENTRIX,APAC,2025-04-24,6,1,5,0,5
REWS,Ireland,SYNERGY GLOBAL HOUSING LLC,EMEA,2025-04-30,16,3,13,13,0
Technical Infrastructure,null,"ROONEY HOLDINGS, INC.",NORTH AMERICA,2025-05-01,3,3,0,0,0
Finance,India,GEP WORLDWIDE,APAC,2025-04-27,4,3,1,0,1
REWS,United States,PROPARK AMERICA WEST LLC,NORTH AMERICA,2025-04-28,2,4,0,0,0
REWS,United Kingdom,REDSTONECONNECT PLC,EMEA,2025-04-22,4,1,3,0,3
Waymo,India,WIPRO LIMITED,APAC,2025-04-27,5,4,2,2,0
T&S,Ireland,ACCENTURE PLC,EMEA,2025-05-01,5,4,3,2,1
Marketing,United States,THE SAGE GROUP,NORTH AMERICA,2025-04-29,3,5,0,0,0
gTech,Poland,TELEPERFORMANCE SE,EMEA,2025-04-28,3,5,0,0,0
YouTube,India,TELEPERFORMANCE SE,APAC,2025-04-24,2,2,0,0,0
POps,India,ACCENTURE PLC,APAC,2025-04-23,5,1,4,4,0
Technical Infrastructure,United States,GARDA WORLD SECURITY CORPORATION,NORTH AMERICA,2025-04-23,7,1,6,6,0
T&S,India,WIPRO LIMITED,APAC,2025-04-25,4,1,3,0,3
Technical Infrastructure,null,CERTIFIED MAINTENANCE SERVICE INC.,NORTH AMERICA,2025-05-01,3,3,0,0,0
YouTube,Philippines,TECH MAHINDRA LIMITED,APAC,2025-04-23,8,3,7,3,4
GBO (w/o gTech & gCS),United States,TIER1 IMPACT PBC INC DBA TIER1 PERFORMANCE,NORTH AMERICA,2025-04-22,3,4,1,0,1
Technical Infrastructure,United States,SCHENKER,NORTH AMERICA,2025-04-23,2,2,0,0,0
POps,India,RANDSTAD NV,APAC,2025-04-28,12,1,11,0,11
Geo,India,WIPRO LIMITED,APAC,2025-04-28,2,4,0,0,0
POps,India,IBM CORPORATION,APAC,2025-04-28,4,3,1,0,1
Cloud,Poland,TTEC HOLDINGS INC,EMEA,2025-04-28,3,5,0,0,0
Technical Infrastructure,United States,"HOLDER CONSTRUCTION GROUP, LLC",NORTH AMERICA,2025-04-23,3,5,0,0,0
POps,India,RANDSTAD NV,APAC,2025-04-25,11,1,10,0,10
Waymo,India,WIPRO LIMITED,APAC,2025-04-30,5,2,3,3,0
Cloud,Philippines,ACCENTURE PLC,APAC,2025-04-23,9,5,6,6,0
YouTube,India,COGNIZANT TECHNOLOGY SOLUTIONS CORPORATION,APAC,2025-04-25,3,3,0,0,0
DeepMind,Brazil,WORK AND CO INTERNATIONAL INC,LATAM,2025-04-25,21,5,18,15,3
gTech,India,TELEPERFORMANCE SE,APAC,2025-04-29,6,3,3,3,0
Waymo,India,WIPRO LIMITED,APAC,2025-04-24,3,2,2,0,2
Technical Infrastructure,null,ALPHA SERVICES CORPORATION,NORTH AMERICA,2025-04-29,3,5,0,0,0
Cloud,Poland,TTEC HOLDINGS INC,EMEA,2025-04-28,3,1,2,0,2
Technical Infrastructure,Thailand,JONES LANG LASALLE INC,APAC,2025-04-23,14,1,13,0,13
gTech,India,GENPACT LIMITED,APAC,2025-04-21,2,4,0,0,0
gTech,Colombia,CONCENTRIX,LATAM,2025-05-01,3,3,0,0,0
Cloud,United Kingdom,ACCENTURE PLC,EMEA,2025-04-24,14,5,11,11,0
REWS,United States,GARDA WORLD SECURITY CORPORATION,NORTH AMERICA,2025-04-29,5,3,2,0,2
REWS,India,COMPASS GROUP PLC,APAC,2025-04-21,3,5,0,0,0
Corp Eng,United States,NIPPON TELEGRAPH AND TELEPHONE CORPORATION,NORTH AMERICA,2025-04-25,6,6,2,0,2
Access,United States,B ROBINSON INC,NORTH AMERICA,2025-05-01,6,2,4,4,0
YouTube,India,COGNIZANT TECHNOLOGY SOLUTIONS CORPORATION,APAC,2025-04-21,2,1,1,1,0
Technical Infrastructure,United States,SCHENKER,NORTH AMERICA,2025-04-25,4,4,0,0,0
YouTube,India,ACCENTURE PLC,APAC,2025-04-21,6,3,5,1,4
gCS,India,TELEDIRECT PTE LTD,APAC,2025-04-24,3,3,0,0,0
YouTube,Poland,COGNIZANT TECHNOLOGY SOLUTIONS CORPORATION,EMEA,2025-04-24,6,2,4,1,3
T&S,Malaysia,ACCENTURE PLC,APAC,2025-04-29,3,4,1,0,1
Geo,India,ACCENTURE PLC,APAC,2025-04-24,3,1,2,2,0
Waymo,United States,TRANSDEV,NORTH AMERICA,2025-04-24,7,3,4,1,3
T&S,India,WIPRO LIMITED,APAC,2025-04-27,4,1,3,1,2
Technical Infrastructure,null,TW CONSTRUCTORS LLC,NORTH AMERICA,2025-04-22,3,5,0,0,0
Technical Infrastructure,United States,SCHENKER,NORTH AMERICA,2025-04-24,2,2,0,0,0
REWS,United States,COMPASS GROUP PLC,NORTH AMERICA,2025-04-25,4,2,2,1,1
Cloud,India,INFOSYS,APAC,2025-04-24,1,1,0,0,0
REWS,United States,"CONCENTRIC GROUP, INC.",NORTH AMERICA,2025-04-30,5,5,2,1,1
gCS,Brazil,TTEC HOLDINGS INC,LATAM,2025-04-25,10,5,7,5,2
Technical Infrastructure,United States,GARDA WORLD SECURITY CORPORATION,NORTH AMERICA,2025-04-25,4,1,3,1,2
T&S,India,WIPRO LIMITED,APAC,2025-04-30,2,1,1,0,1
Waymo,India,WIPRO LIMITED,APAC,2025-04-30,2,3,0,0,0
REWS,null,SODEXO,APAC,2025-04-21,3,5,0,0,0
Technical Infrastructure,Netherlands,SECURITAS AB,EMEA,2025-04-28,4,1,3,3,0
REWS,India,SODEXO,APAC,2025-05-02,3,3,0,0,0
Technical Infrastructure,null,"HOLDER CONSTRUCTION GROUP, LLC",NORTH AMERICA,2025-04-24,3,3,0,0,0
gTech,India,VIRTUSA CORPORATION,APAC,2025-04-25,3,3,0,0,0
POps,India,RANDSTAD NV,APAC,2025-05-02,7,6,3,2,1
REWS,Canada,JOHNSON CONTROLS INTERNATIONAL PLC,NORTH AMERICA,2025-04-21,1,3,0,0,0
Cloud,Philippines,HCL TECHNOLOGIES LTD,APAC,2025-04-30,10,1,9,0,9
Technical Infrastructure,null,SISTEMAS CONTRA INCENDIOS EUROCOMERCIAL LTDA,LATAM,2025-04-28,3,5,0,0,0
POps,United States,ACCENTURE PLC,NORTH AMERICA,2025-04-23,6,1,5,0,5
Waymo,United States,TRANSDEV,NORTH AMERICA,2025-05-02,8,2,6,0,6
Corp Eng,India,MOVATE TECHNOLOGIES PRIVATE LIMITED,APAC,2025-04-22,5,2,3,2,1
REWS,United States,SYSTEM ONE HOLDINGS LLC DBA TEAMPEOPLE,NORTH AMERICA,2025-05-01,3,3,0,0,0
POps,Taiwan,DELOITTE,APAC,2025-04-29,3,5,0,0,0
Cloud,United States,ONIX NETWORKING CORP.,NORTH AMERICA,2025-04-29,6,4,2,2,0
REWS,India,SIMPLIWORK OFFICES PRIVATE LIMITED,APAC,2025-04-25,2,2,0,0,0
gTech,India,VIRTUSA CORPORATION,APAC,2025-04-25,3,2,1,0,1
Waymo,India,WIPRO LIMITED,APAC,2025-04-24,3,4,0,0,0
gCS,India,WNS (HOLDINGS) LIMITED,APAC,2025-04-24,3,1,2,2,0
Platforms + Ecosystems,India,ACCENTURE PLC,APAC,2025-04-29,4,2,2,0,2
gTech,Poland,TELEPERFORMANCE SE,EMEA,2025-04-28,3,5,0,0,0
Cloud,El Salvador,SERVICESOURCE INTERNATIONAL INC,LATAM,2025-04-28,3,5,0,0,0
YouTube,India,CONCENTRIX,APAC,2025-04-28,6,4,4,4,0
REWS,India,JONES LANG LASALLE INC,APAC,2025-05-02,3,3,0,0,0
gTech,India,COGNIZANT TECHNOLOGY SOLUTIONS CORPORATION,APAC,2025-04-25,3,3,0,0,0
gCS,Philippines,TELEDIRECT PTE LTD,APAC,2025-05-02,20,5,17,8,9
REWS,India,JONES LANG LASALLE INC,APAC,2025-05-02,3,3,0,0,0
REWS,Singapore,SECURITY AND RISK SOLUTIONS PTE LTD,APAC,2025-04-29,6,2,4,1,3
REWS,India,JONES LANG LASALLE INC,APAC,2025-05-02,3,3,0,0,0
Technical Infrastructure,null,SATURN PARTNERS LLC,NORTH AMERICA,2025-04-24,3,3,0,0,0
Technical Infrastructure,United States,GXO LOGISTICS WORLDWIDE LLC,NORTH AMERICA,2025-04-25,3,2,1,0,1
Technical Infrastructure,null,"HOLDER CONSTRUCTION GROUP, LLC",NORTH AMERICA,2025-05-01,3,3,0,0,0
gCS,Philippines,CONCENTRIX,APAC,2025-04-30,2,2,0,0,0
Corp Eng,null,ONE DIVERSIFIED LLC,NORTH AMERICA,2025-04-28,3,5,0,0,0
T&S,Portugal,COGNIZANT TECHNOLOGY SOLUTIONS CORPORATION,EMEA,2025-04-23,5,2,3,1,2
Technical Infrastructure,Philippines,ACCENTURE PLC,APAC,2025-04-22,3,4,1,1,0
Platforms + Ecosystems,United States,CIENET INTERNATIONAL LLC,NORTH AMERICA,2025-05-02,3,3,0,0,0
Waymo,India,WIPRO LIMITED,APAC,2025-04-30,2,2,0,0,0
Cloud,United States,ONIX NETWORKING CORP.,NORTH AMERICA,2025-04-29,4,5,1,0,1
gTech,Philippines,ACCENTURE PLC,APAC,2025-04-23,1,1,0,0,0
gTech,India,VIRTUSA CORPORATION,APAC,2025-04-25,3,3,0,0,0
T&S,United States,"MINDLANCE, INC.",NORTH AMERICA,2025-04-28,10,8,7,1,6
Research,United States,"TRIPLE CROWN CONSULTING, LLC",NORTH AMERICA,2025-05-01,3,2,1,0,1
Corp Eng,India,MOVATE TECHNOLOGIES PRIVATE LIMITED,APAC,2025-04-21,4,1,3,1,2
gTech,Greece,TELEPERFORMANCE SE,EMEA,2025-04-29,8,5,5,0,5
REWS,India,SODEXO,APAC,2025-04-23,2,2,0,0,0
Technical Infrastructure,United States,"HOLDER CONSTRUCTION GROUP, LLC",NORTH AMERICA,2025-04-25,5,7,0,0,0
Cloud,United States,MEDIATEK INC,NORTH AMERICA,2025-04-29,18,5,15,14,1
Technical Infrastructure,United States,TURNER & TOWNSEND PARTNERS LLP,NORTH AMERICA,2025-04-21,6,4,4,0,4
gTech,India,COGNIZANT TECHNOLOGY SOLUTIONS CORPORATION,APAC,2025-04-27,4,3,1,0,1
Technical Infrastructure,United Kingdom,SYNERGY SECURITY SOLUTIONS LIMITED,EMEA,2025-04-29,3,4,1,0,1
Technical Infrastructure,United States,GXO LOGISTICS WORLDWIDE LLC,NORTH AMERICA,2025-04-29,5,2,3,3,0
Marketing,India,CYBAGE SOFTWARE PRIVATE LIMITED,APAC,2025-04-21,5,3,2,1,1
Geo,India,COGNIZANT TECHNOLOGY SOLUTIONS CORPORATION,APAC,2025-04-27,3,2,1,0,1
Cloud,Spain,TELEPERFORMANCE SE,EMEA,2025-04-28,3,5,0,0,0
Technical Infrastructure,null,CATHEXIS HOLDINGS LP,EMEA,2025-05-02,3,3,0,0,0
Finance,United States,INTELLIPRO GROUP INC.,NORTH AMERICA,2025-04-24,8,12,2,2,0
HUE,United States,COMEDIA DESIGN INC,NORTH AMERICA,2025-04-22,7,4,5,0,5
POps,India,ACCENTURE PLC,APAC,2025-04-30,4,4,2,2,0
Technical Infrastructure,United States,"HOLDER CONSTRUCTION GROUP, LLC",NORTH AMERICA,2025-04-30,2,2,0,0,0
REWS,India,COMPASS GROUP PLC,APAC,2025-04-21,3,5,0,0,0
Technical Infrastructure,United States,SKYBOX CRITICAL OPERATIONS LLC,NORTH AMERICA,2025-04-23,2,1,1,0,1
Technical Infrastructure,null,C D MOODY CONSTRUCTION COMPANY INC,NORTH AMERICA,2025-04-24,3,3,0,0,0
Cloud,Romania,COGNIZANT TECHNOLOGY SOLUTIONS CORPORATION,EMEA,2025-04-30,4,4,2,2,0
Research,United States,"MAGNIT, LLC",NORTH AMERICA,2025-04-30,7,7,5,0,5
Search,Malaysia,TECH MAHINDRA LIMITED,APAC,2025-04-23,3,3,2,0,2
REWS,India,JONES LANG LASALLE INC,APAC,2025-04-22,1,1,0,0,0
T&S,India,COGNIZANT TECHNOLOGY SOLUTIONS CORPORATION,APAC,2025-04-28,5,1,4,0,4
DeepMind,United States,SCALE AI INC,NORTH AMERICA,2025-04-21,17,1,16,2,14
Geo,India,WIPRO LIMITED,APAC,2025-04-28,2,4,0,0,0
Devices & Services,United States,"CADENCE DESIGN SYSTEMS, INC.",NORTH AMERICA,2025-05-01,7,6,3,1,2
T&S,India,WIPRO LIMITED,APAC,2025-04-27,3,2,1,0,1
Waymo,India,WIPRO LIMITED,APAC,2025-05-01,3,3,0,0,0
T&S,India,WIPRO LIMITED,APAC,2025-04-30,3,3,2,0,2
YouTube,Portugal,COGNIZANT TECHNOLOGY SOLUTIONS CORPORATION,EMEA,2025-04-22,6,2,4,3,1
Cloud,United States,GLOBALLOGIC INC,NORTH AMERICA,2025-04-25,2,1,1,0,1
gTech,India,GENPACT LIMITED,APAC,2025-04-21,2,1,1,1,0
YouTube,Portugal,GENPACT LIMITED,EMEA,2025-04-30,7,2,5,1,4
gTech,Philippines,TELUS,APAC,2025-04-23,3,4,1,0,1
Platforms + Ecosystems,Hong Kong,"AKRAYA, INC",APAC,2025-04-23,7,2,5,0,5
Technical Infrastructure,United States,ROSENDIN ELECTRIC INC.,NORTH AMERICA,2025-04-21,2,4,0,0,0
gTech,India,VIRTUSA CORPORATION,APAC,2025-04-25,3,3,0,0,0
Platforms + Ecosystems,United States,MAGIC LEAP INC.,NORTH AMERICA,2025-04-24,6,2,4,1,3
YouTube,India,GENPACT LIMITED,APAC,2025-04-28,3,2,1,1,0
T&S,India,WIPRO LIMITED,APAC,2025-04-30,3,3,2,1,1
gTech,United States,VACO,NORTH AMERICA,2025-04-28,3,5,0,0,0
T&S,United States,"US TECH SOLUTIONS, INC.",NORTH AMERICA,2025-04-21,6,9,3,3,0
Technical Infrastructure,United States,DIRECT LINE GLOBAL LLC,NORTH AMERICA,2025-04-25,2,2,0,0,0
gTech,India,VIRTUSA CORPORATION,APAC,2025-04-25,3,2,1,0,1
T&S,Portugal,COGNIZANT TECHNOLOGY SOLUTIONS CORPORATION,EMEA,2025-04-21,5,1,4,4,0
Waymo,India,COGNIZANT TECHNOLOGY SOLUTIONS CORPORATION,APAC,2025-04-24,2,1,1,0,1
YouTube,India,ACCENTURE PLC,APAC,2025-04-21,6,3,5,2,3
Access,United States,SANDCASTLE COMMUNICATIONS LLC,NORTH AMERICA,2025-05-01,8,3,5,0,5
Technical Infrastructure,India,HT GLOBAL IT SOLUTIONS HOLDINGS LIMITED,APAC,2025-05-02,4,2,2,0,2
Technical Infrastructure,United States,SYNCREON GLOBAL HOLDINGS LIMITED,NORTH AMERICA,2025-05-02,12,2,10,1,9
Technical Infrastructure,United States,GXO LOGISTICS WORLDWIDE LLC,NORTH AMERICA,2025-04-29,5,6,1,0,1
YouTube,India,GENPACT LIMITED,APAC,2025-04-24,1,2,0,0,0
gTech,United States,VACO,NORTH AMERICA,2025-04-28,3,2,1,0,1
REWS,China,EXOS,APAC,2025-04-24,1,1,0,0,0
T&S,India,COGNIZANT TECHNOLOGY SOLUTIONS CORPORATION,APAC,2025-04-23,2,1,1,0,1
T&S,Philippines,ACCENTURE PLC,APAC,2025-04-28,9,3,6,0,6
T&S,Philippines,ACCENTURE PLC,APAC,2025-05-02,7,1,6,0,6
Health,United States,"MEDAMERICA CONSULTING EMPLOYEES, INC.",NORTH AMERICA,2025-04-25,4,2,2,1,1
Finance,Philippines,ACCENTURE PLC,APAC,2025-04-28,3,1,2,0,2
Technical Infrastructure,United States,"MOODY - HOLDER JV, A JOINT VENTURE",NORTH AMERICA,2025-04-23,1,1,0,0,0
Cloud,India,DELOITTE,APAC,2025-05-01,3,2,1,0,1
Waymo,India,COGNIZANT TECHNOLOGY SOLUTIONS CORPORATION,APAC,2025-04-29,3,4,1,0,1
Cloud,Spain,TELEPERFORMANCE SE,EMEA,2025-04-28,3,5,0,0,0
Finance,Philippines,ACCENTURE PLC,APAC,2025-04-22,3,5,0,0,0
gTech,India,TELEPERFORMANCE SE,APAC,2025-04-27,5,3,2,1,1
Corp Eng,India,ASTREYA PARTNERS INC,APAC,2025-04-21,3,1,2,0,2
REWS,United States,"INTER-CON SECURITY SYSTEMS, INC.",NORTH AMERICA,2025-04-30,5,7,0,0,0
Corp Eng,Taiwan,ASTREYA PARTNERS INC,APAC,2025-05-02,7,5,4,0,4
Technical Infrastructure,United States,SCHENKER,NORTH AMERICA,2025-04-25,4,4,0,0,0
Cloud,India,COGNIZANT TECHNOLOGY SOLUTIONS CORPORATION,APAC,2025-04-25,2,2,0,0,0
Cloud,Philippines,HCL TECHNOLOGIES LTD,APAC,2025-05-01,10,5,7,7,0
gTech,India,TELEPERFORMANCE SE,APAC,2025-04-22,2,3,1,1,0
Waymo,India,WIPRO LIMITED,APAC,2025-04-30,6,3,3,1,2
REWS,United States,GARDINER & THEOBALD LLP,NORTH AMERICA,2025-05-01,5,5,2,2,0
Finance,India,LATENTVIEW ANALYTICS CORPORATION,APAC,2025-04-23,6,1,5,0,5
POps,India,RANDSTAD NV,APAC,2025-04-27,9,2,7,0,7
gTech,Philippines,ACCENTURE PLC,APAC,2025-04-29,3,4,1,0,1
Technical Infrastructure,United States,TW CONSTRUCTORS LLC,NORTH AMERICA,2025-04-25,2,2,0,0,0
gTech,India,VACO,APAC,2025-04-28,5,1,4,0,4
Technical Infrastructure,United States,MCFARLAND BUILDING GROUP LLC,NORTH AMERICA,2025-04-21,2,4,0,0,0
REWS,India,JONES LANG LASALLE INC,APAC,2025-05-02,3,3,0,0,0
gCS,India,TELEDIRECT PTE LTD,APAC,2025-04-25,4,3,1,1,0
POps,India,ACCENTURE PLC,APAC,2025-04-28,3,2,1,1,0
Cloud,Mexico,TATA GROUP,LATAM,2025-04-23,9,5,6,2,4
Devices & Services,United States,ARCLIGHT WIRELESS INC,NORTH AMERICA,2025-04-27,6,3,5,0,5
gCS,India,REGALIX INC,APAC,2025-04-24,3,2,1,1,0
Ads & Commerce,India,GLOBALLOGIC INC,APAC,2025-04-29,1,1,0,0,0
Technical Infrastructure,United States,GXO LOGISTICS WORLDWIDE LLC,NORTH AMERICA,2025-05-02,3,3,0,0,0
gTech,India,VIRTUSA CORPORATION,APAC,2025-04-25,3,3,0,0,0
YouTube,Malaysia,CONCENTRIX,APAC,2025-04-24,7,1,6,1,5
T&S,Philippines,ACCENTURE PLC,APAC,2025-04-25,10,5,7,7,0
YouTube,India,GENPACT LIMITED,APAC,2025-04-28,3,2,1,1,0
REWS,India,SIMPLIWORK OFFICES PRIVATE LIMITED,APAC,2025-04-23,2,2,0,0,0
REWS,India,JONES LANG LASALLE INC,APAC,2025-04-22,1,1,0,0,0
gTech,India,TELEPERFORMANCE SE,APAC,2025-04-22,4,5,1,0,1
Devices & Services,United States,SOURCE INTELLIGENCE,NORTH AMERICA,2025-05-01,10,7,5,0,5
Access,United States,NETCRACKER TECHNOLOGY CORPORATION,NORTH AMERICA,2025-04-21,11,4,9,9,0
YouTube,India,CONCENTRIX,APAC,2025-04-30,3,5,0,0,0
Cloud,India,COGNIZANT TECHNOLOGY SOLUTIONS CORPORATION,APAC,2025-05-02,4,3,1,1,0
gCS,India,ACCENTURE PLC,APAC,2025-04-29,5,1,4,4,0
Geo,India,WIPRO LIMITED,APAC,2025-04-23,2,1,1,0,1
Waymo,India,COGNIZANT TECHNOLOGY SOLUTIONS CORPORATION,APAC,2025-04-24,2,2,0,0,0
Cloud,United States,"MAGNIT, LLC",NORTH AMERICA,2025-04-22,13,7,10,10,0
Technical Infrastructure,Netherlands,PUBLYON B.V.,EMEA,2025-04-22,18,6,14,0,14
Cloud,Philippines,ACCENTURE PLC,APAC,2025-04-24,3,3,0,0,0
REWS,India,JONES LANG LASALLE INC,APAC,2025-04-22,1,1,0,0,0
gTech,India,TECH MAHINDRA LIMITED,APAC,2025-04-27,3,2,1,1,0
Technical Infrastructure,United States,SATURN PARTNERS LLC,NORTH AMERICA,2025-04-23,2,2,0,0,0
Devices & Services,India,WIPRO LIMITED,APAC,2025-04-23,8,4,6,5,1
gTech,India,COGNIZANT TECHNOLOGY SOLUTIONS CORPORATION,APAC,2025-05-01,3,3,0,0,0
T&S,India,CONCENTRIX,APAC,2025-04-22,5,6,1,0,1
Cloud,India,DELOITTE,APAC,2025-04-22,3,4,1,0,1
Technical Infrastructure,Thailand,JONES LANG LASALLE INC,APAC,2025-04-27,17,1,16,1,15
T&S,India,WIPRO LIMITED,APAC,2025-04-30,5,2,3,2,1
Technical Infrastructure,United States,SCHENKER,NORTH AMERICA,2025-04-25,2,2,0,0,0
Platforms + Ecosystems,India,HCL TECHNOLOGIES LTD,APAC,2025-04-29,4,5,1,0,1
Cloud,Philippines,ACCENTURE PLC,APAC,2025-04-23,1,2,0,0,0
gTech,India,TECH MAHINDRA LIMITED,APAC,2025-04-27,3,2,1,1,0
T&S,India,WIPRO LIMITED,APAC,2025-04-25,3,1,2,0,2
Cloud,India,INFOSYS,APAC,2025-04-28,7,4,5,0,5
Geo,India,COGNIZANT TECHNOLOGY SOLUTIONS CORPORATION,APAC,2025-04-24,1,1,0,0,0
gTech,India,TECH MAHINDRA LIMITED,APAC,2025-04-27,3,2,1,0,1
gTech,Poland,TELEPERFORMANCE SE,EMEA,2025-04-29,4,6,0,0,0
Platforms + Ecosystems,Brazil,COGNIZANT TECHNOLOGY SOLUTIONS CORPORATION,LATAM,2025-04-21,4,6,0,0,0
POps,India,RANDSTAD NV,APAC,2025-04-30,5,1,4,2,2
gCS,India,TELEDIRECT PTE LTD,APAC,2025-05-02,14,4,10,9,1
Technical Infrastructure,United States,DIRECT LINE GLOBAL LLC,NORTH AMERICA,2025-04-28,1,3,0,0,0
T&S,India,COGNIZANT TECHNOLOGY SOLUTIONS CORPORATION,APAC,2025-04-22,2,3,1,0,1
gTech,India,COGNIZANT TECHNOLOGY SOLUTIONS CORPORATION,APAC,2025-05-01,3,3,0,0,0
Access,United States,INSIGHT,NORTH AMERICA,2025-04-30,6,2,4,0,4
Waymo,United States,KPMG,NORTH AMERICA,2025-04-24,3,2,1,0,1
REWS,France,CBRE GROUP INC,EMEA,2025-04-22,5,7,0,0,0
Platforms + Ecosystems,United States,VIRTUSA CORPORATION,NORTH AMERICA,2025-04-22,7,5,4,4,0
Technical Infrastructure,United States,GXO LOGISTICS WORLDWIDE LLC,NORTH AMERICA,2025-04-25,6,4,4,0,4
gTech,India,COGNIZANT TECHNOLOGY SOLUTIONS CORPORATION,APAC,2025-04-21,2,1,1,1,0
T&S,India,WIPRO LIMITED,APAC,2025-04-29,5,1,4,0,4
REWS,Japan,COMPASS GROUP PLC,APAC,2025-04-25,3,3,0,0,0
Technical Infrastructure,United Kingdom,SYNERGY SECURITY SOLUTIONS LIMITED,EMEA,2025-04-22,3,4,1,1,0
REWS,United States,ALLIED UNIVERSAL,NORTH AMERICA,2025-04-22,9,5,6,5,1
Waymo,United States,AMERIT FLEET SOLUTIONS INC.,NORTH AMERICA,2025-04-21,4,3,1,0,1
gTech,United States,TECH MAHINDRA LIMITED,NORTH AMERICA,2025-04-29,5,3,2,1,1
REWS,Japan,COMPASS GROUP PLC,APAC,2025-05-01,7,3,4,0,4
Technical Infrastructure,United States,SALUTE INCORPORATED,NORTH AMERICA,2025-04-25,6,1,5,1,4
Ads & Commerce,India,TELEPERFORMANCE SE,APAC,2025-04-23,5,2,3,0,3
Technical Infrastructure,United States,TRICOPP LLC,NORTH AMERICA,2025-04-22,4,2,2,1,1
gTech,India,TELEPERFORMANCE SE,APAC,2025-05-01,3,3,1,0,1
Technical Infrastructure,null,SCHENKER,NORTH AMERICA,2025-04-25,3,3,0,0,0
POps,India,ACCENTURE PLC,APAC,2025-04-24,7,1,6,5,1
T&S,Philippines,ACCENTURE PLC,APAC,2025-05-02,7,2,5,3,2
Waymo,United States,LINKAGE DESIGN LLC,NORTH AMERICA,2025-05-01,6,2,4,0,4
gTech,India,ACCENTURE PLC,APAC,2025-04-22,1,1,0,0,0
Technical Infrastructure,null,NIPPON TELEGRAPH AND TELEPHONE CORPORATION,APAC,2025-04-25,3,3,0,0,0
Technical Infrastructure,United States,"HOLDER CONSTRUCTION GROUP, LLC",NORTH AMERICA,2025-04-30,2,2,0,0,0
YouTube,India,TELEPERFORMANCE SE,APAC,2025-04-22,4,5,1,0,1
T&S,India,WIPRO LIMITED,APAC,2025-04-25,2,2,0,0,0
REWS,United States,"INTER-CON SECURITY SYSTEMS, INC.",NORTH AMERICA,2025-04-22,5,2,3,3,0
YouTube,India,CONCENTRIX,APAC,2025-04-28,4,2,2,2,0
T&S,Ireland,ACCENTURE PLC,EMEA,2025-04-22,4,1,3,1,2
Waymo,United States,TRANSDEV,NORTH AMERICA,2025-05-01,7,2,5,2,3
Technical Infrastructure,United States,GXO LOGISTICS WORLDWIDE LLC,NORTH AMERICA,2025-04-25,3,2,1,0,1
POps,Australia,BUPA HEALTH CENTRES PTY LTD,APAC,2025-04-24,2,2,0,0,0
gCS,China,ACCENTURE PLC,APAC,2025-04-22,8,4,6,0,6
POps,India,ACCENTURE PLC,APAC,2025-04-22,5,1,4,1,3
gTech,India,COGNIZANT TECHNOLOGY SOLUTIONS CORPORATION,APAC,2025-04-23,4,1,3,3,0
REWS,India,SODEXO,APAC,2025-04-22,1,1,0,0,0
REWS,India,JONES LANG LASALLE INC,APAC,2025-04-23,2,2,0,0,0
Technical Infrastructure,null,SATURN PARTNERS LLC,NORTH AMERICA,2025-04-24,3,3,0,0,0
T&S,United States,PYRAMID CONSULTING INC.,NORTH AMERICA,2025-04-29,11,8,7,7,0
gTech,United States,VACO,NORTH AMERICA,2025-04-30,5,2,3,0,3
Waymo,India,WIPRO LIMITED,APAC,2025-05-01,7,1,6,0,6
Waymo,India,COGNIZANT TECHNOLOGY SOLUTIONS CORPORATION,APAC,2025-04-23,1,1,0,0,0
REWS,United States,SYSTEM ONE HOLDINGS LLC DBA TEAMPEOPLE,NORTH AMERICA,2025-05-02,5,5,2,2,0
Marketing,null,CHESAMEL GROUP LIMITED,EMEA,2025-04-25,3,3,0,0,0
REWS,null,JONES LANG LASALLE INC,APAC,2025-04-25,3,3,0,0,0
REWS,India,JONES LANG LASALLE INC,APAC,2025-04-22,1,1,0,0,0
Geo,Philippines,ACCENTURE PLC,APAC,2025-04-29,4,2,2,0,2
Marketing,United States,"MAGNIT, LLC",NORTH AMERICA,2025-04-22,19,15,0,0,0
Technical Infrastructure,null,ISS A/S,EMEA,2025-05-01,3,3,0,0,0
gTech,United States,PWC,NORTH AMERICA,2025-04-23,8,4,6,2,4
gTech,India,TECH MAHINDRA LIMITED,APAC,2025-04-27,3,2,1,0,1
Devices & Services,India,"CADENCE DESIGN SYSTEMS, INC.",APAC,2025-04-21,13,2,11,11,0
REWS,Canada,COMPASS GROUP PLC,NORTH AMERICA,2025-05-01,3,3,0,0,0
T&S,Philippines,ACCENTURE PLC,APAC,2025-05-02,7,2,5,0,5
T&S,India,WIPRO LIMITED,APAC,2025-04-25,2,1,1,0,1
Technical Infrastructure,Denmark,QVISTGAARD IS,EMEA,2025-05-01,3,4,0,0,0
HUE,United States,COMEDIA DESIGN INC,NORTH AMERICA,2025-04-23,8,4,6,0,6
T&S,Portugal,COGNIZANT TECHNOLOGY SOLUTIONS CORPORATION,EMEA,2025-04-23,7,3,4,0,4
Cloud,India,COGNIZANT TECHNOLOGY SOLUTIONS CORPORATION,APAC,2025-04-28,2,4,0,0,0
gCS,India,REGALIX INC,APAC,2025-04-25,4,3,1,1,0
T&S,India,WIPRO LIMITED,APAC,2025-04-30,5,2,3,1,2
Technical Infrastructure,United States,"HOLDER CONSTRUCTION GROUP, LLC",NORTH AMERICA,2025-05-02,3,3,0,0,0
Corp Eng,India,DELOITTE,APAC,2025-04-21,2,4,0,0,0
Waymo,India,WIPRO LIMITED,APAC,2025-04-27,4,1,3,0,3
Technical Infrastructure,United States,ALLIED UNIVERSAL,NORTH AMERICA,2025-04-28,4,3,1,1,0
REWS,null,COMPASS GROUP PLC,EMEA,2025-04-25,3,3,0,0,0
Research,United States,INTELLIPRO GROUP INC.,NORTH AMERICA,2025-04-25,16,6,14,0,14
Geo,India,WIPRO LIMITED,APAC,2025-04-23,2,2,0,0,0
T&S,India,WIPRO LIMITED,APAC,2025-04-23,4,4,2,0,2
REWS,United States,GARDA WORLD SECURITY CORPORATION,NORTH AMERICA,2025-04-24,13,4,10,4,6
T&S,Malaysia,ACCENTURE PLC,APAC,2025-04-25,8,3,5,1,4
T&S,Malaysia,ACCENTURE PLC,APAC,2025-04-28,3,5,0,0,0
Devices & Services,India,HCL TECHNOLOGIES LTD,APAC,2025-04-21,6,5,3,0,3
Technical Infrastructure,United Kingdom,GLEAVE PARTNERSHIP LIMITED,EMEA,2025-04-21,8,1,7,3,4
Search,India,GLOBALLOGIC INC,APAC,2025-05-01,2,3,0,0,0
Geo,India,ACCENTURE PLC,APAC,2025-04-28,5,1,4,1,3
Waymo,United States,TRANSDEV,NORTH AMERICA,2025-04-22,4,1,3,1,2
T&S,Portugal,COGNIZANT TECHNOLOGY SOLUTIONS CORPORATION,EMEA,2025-04-22,6,1,5,4,1
Technical Infrastructure,United States,SCHENKER,NORTH AMERICA,2025-04-28,5,2,3,0,3
Technical Infrastructure,Hong Kong,ERICSSON INC,APAC,2025-04-24,1,1,0,0,0
Technical Infrastructure,United States,CROFT CONSULTING SERVICES LLC,NORTH AMERICA,2025-05-02,3,3,0,0,0
Technical Infrastructure,United States,MCFARLAND BUILDING GROUP LLC,NORTH AMERICA,2025-05-01,3,3,0,0,0
gTech,India,TELEPERFORMANCE SE,APAC,2025-04-22,5,2,3,1,2
Geo,India,COGNIZANT TECHNOLOGY SOLUTIONS CORPORATION,APAC,2025-04-24,3,2,1,0,1
REWS,India,JAGUAR SECURITY SERVICES PVT. LTD.,APAC,2025-04-23,1,1,0,0,0
T&S,Malaysia,COGNIZANT TECHNOLOGY SOLUTIONS CORPORATION,APAC,2025-04-23,2,1,1,0,1
gTech,United States,CONCENTRIX,NORTH AMERICA,2025-04-22,19,26,1,1,0
Technical Infrastructure,null,C D MOODY CONSTRUCTION COMPANY INC,NORTH AMERICA,2025-04-24,3,3,0,0,0
YouTube,India,ACCENTURE PLC,APAC,2025-04-22,7,3,6,1,5
Technical Infrastructure,United States,SCHENKER,NORTH AMERICA,2025-04-22,6,1,5,5,0
Cloud,India,COGNIZANT TECHNOLOGY SOLUTIONS CORPORATION,APAC,2025-04-25,3,2,1,0,1
Cloud,Brazil,TTEC HOLDINGS INC,LATAM,2025-04-24,7,2,5,5,0
gTech,India,VIRTUSA CORPORATION,APAC,2025-04-21,4,3,1,1,0
Devices & Services,China,SUPPLY CHAIN RESOURCES,APAC,2025-04-28,8,2,6,6,0
Cloud,Mexico,TATA GROUP,LATAM,2025-04-21,9,3,6,5,1
Technical Infrastructure,Netherlands,SYNCREON GLOBAL HOLDINGS LIMITED,EMEA,2025-04-22,7,5,4,4,0
gTech,India,TELEPERFORMANCE SE,APAC,2025-04-21,5,2,3,3,0
gTech,United States,VACO,NORTH AMERICA,2025-04-30,5,2,3,1,2
Geo,India,WIPRO LIMITED,APAC,2025-04-25,2,2,0,0,0
YouTube,Malaysia,COGNIZANT TECHNOLOGY SOLUTIONS CORPORATION,APAC,2025-04-23,2,2,0,0,0
T&S,India,COGNIZANT TECHNOLOGY SOLUTIONS CORPORATION,APAC,2025-04-21,1,null,1,1,0
Corp Eng,United States,ASTREYA PARTNERS INC,NORTH AMERICA,2025-04-30,5,1,4,4,0
gTech,India,COGNIZANT TECHNOLOGY SOLUTIONS CORPORATION,APAC,2025-04-25,3,2,1,1,0
Technical Infrastructure,United States,GXO LOGISTICS WORLDWIDE LLC,NORTH AMERICA,2025-05-01,7,3,4,4,0
POps,India,RANDSTAD NV,APAC,2025-04-24,10,1,9,5,4
T&S,India,WIPRO LIMITED,APAC,2025-04-30,3,3,2,0,2
YouTube,United States,ACCENTURE PLC,NORTH AMERICA,2025-05-02,4,3,1,0,1
REWS,United States,COMPASS GROUP PLC,NORTH AMERICA,2025-04-22,1,1,0,0,0
Waymo,United States,TRANSDEV,NORTH AMERICA,2025-05-01,7,2,5,0,5
gTech,India,TELEPERFORMANCE SE,APAC,2025-04-22,5,1,4,1,3
Technical Infrastructure,United States,TW CONSTRUCTORS LLC,NORTH AMERICA,2025-04-22,3,4,1,1,0
Cloud,Brazil,SURESKILLS LIMITED,LATAM,2025-05-02,7,2,5,0,5
gTech,India,COGNIZANT TECHNOLOGY SOLUTIONS CORPORATION,APAC,2025-04-23,2,2,0,0,0
Technical Infrastructure,United States,ALLIED UNIVERSAL,NORTH AMERICA,2025-05-01,3,3,0,0,0
Corp Eng,United States,DELOITTE,NORTH AMERICA,2025-04-22,4,2,2,2,0
Technical Infrastructure,Belgium,GXO LOGISTICS WORLDWIDE LLC,EMEA,2025-04-24,2,1,1,1,0
T&S,Poland,ACCENTURE PLC,EMEA,2025-04-22,8,5,5,0,5
Technical Infrastructure,United States,DIRECT LINE GLOBAL LLC,NORTH AMERICA,2025-04-24,1,1,0,0,0
gTech,India,TELEPERFORMANCE SE,APAC,2025-05-01,4,3,3,3,0
Cloud,Brazil,ACCENTURE PLC,LATAM,2025-04-28,3,2,1,0,1
Cloud,Philippines,ACCENTURE PLC,APAC,2025-04-24,1,1,0,0,0
Ads & Commerce,India,TELEPERFORMANCE SE,APAC,2025-04-23,5,null,5,5,0
REWS,Japan,JONES LANG LASALLE INC,APAC,2025-04-23,2,2,0,0,0
YouTube,Greece,TELEPERFORMANCE SE,EMEA,2025-04-30,2,2,0,0,0
Cloud,Romania,COGNIZANT TECHNOLOGY SOLUTIONS CORPORATION,EMEA,2025-04-29,5,1,4,0,4
YouTube,India,GENPACT LIMITED,APAC,2025-04-28,3,2,1,0,1
YouTube,Ireland,ACCENTURE PLC,EMEA,2025-04-28,3,2,1,0,1
gTech,India,VIRTUSA CORPORATION,APAC,2025-04-25,3,2,1,0,1
gTech,United States,VACO,NORTH AMERICA,2025-04-21,3,1,2,0,2
REWS,India,JONES LANG LASALLE INC,APAC,2025-05-02,3,3,0,0,0
REWS,India,JONES LANG LASALLE INC,APAC,2025-04-23,1,1,0,0,0
Technical Infrastructure,United States,M A MORTENSON COMPANY,NORTH AMERICA,2025-04-28,1,3,0,0,0
Waymo,India,Xitadel CAE Technologies India Private Limited,APAC,2025-04-25,3,1,2,1,1
Technical Infrastructure,United States,SCHENKER,NORTH AMERICA,2025-04-30,2,2,0,0,0
gTech,Philippines,CONCENTRIX,APAC,2025-04-25,4,2,2,0,2
gCS,India,TELEDIRECT PTE LTD,APAC,2025-04-25,4,2,2,2,0
Geo,India,COGNIZANT TECHNOLOGY SOLUTIONS CORPORATION,APAC,2025-04-28,3,5,0,0,0
Waymo,India,WIPRO LIMITED,APAC,2025-05-01,3,3,0,0,0
Technical Infrastructure,United States,SCHENKER,NORTH AMERICA,2025-04-28,4,6,0,0,0
Devices & Services,Colombia,EPAM SYSTEMS INC,LATAM,2025-04-21,4,1,3,0,3
gTech,Malaysia,TELEDIRECT PTE LTD,APAC,2025-04-21,2,1,1,1,0
Devices & Services,United States,ACCENTURE PLC,NORTH AMERICA,2025-04-28,7,5,4,0,4
Technical Infrastructure,United States,ALLIED UNIVERSAL,NORTH AMERICA,2025-04-22,3,4,1,0,1
Access,United States,"GARY D. NELSON ASSOCIATES, INC.",NORTH AMERICA,2025-04-27,5,9,1,0,1
REWS,India,JONES LANG LASALLE INC,APAC,2025-04-24,3,3,0,0,0
T&S,Portugal,COGNIZANT TECHNOLOGY SOLUTIONS CORPORATION,EMEA,2025-04-22,6,2,4,3,1
Cloud,Mexico,TATA GROUP,LATAM,2025-04-22,15,3,12,2,10
Technical Infrastructure,Finland,SECTOR ALARM GROUP AS,EMEA,2025-04-28,1,3,0,0,0
REWS,India,JONES LANG LASALLE INC,APAC,2025-05-02,3,3,0,0,0
gCS,India,ACCENTURE PLC,APAC,2025-04-22,9,1,8,0,8
T&S,India,WIPRO LIMITED,APAC,2025-04-30,5,1,4,0,4
Waymo,India,WIPRO LIMITED,APAC,2025-05-01,3,1,2,0,2
gTech,United States,VACO,NORTH AMERICA,2025-04-29,4,5,1,1,0
REWS,India,G4S PLC,APAC,2025-04-24,1,1,0,0,0
Cloud,Canada,TELUS,NORTH AMERICA,2025-04-23,5,5,2,2,0
Waymo,India,COGNIZANT TECHNOLOGY SOLUTIONS CORPORATION,APAC,2025-04-24,2,1,1,0,1
Technical Infrastructure,United States,"HOLDER CONSTRUCTION GROUP, LLC",NORTH AMERICA,2025-04-29,1,1,0,0,0
YouTube,Philippines,CONCENTRIX,APAC,2025-04-22,14,1,13,7,6
gTech,India,TECH MAHINDRA LIMITED,APAC,2025-04-23,5,2,3,0,3
Waymo,India,COGNIZANT TECHNOLOGY SOLUTIONS CORPORATION,APAC,2025-05-01,3,3,0,0,0
gCS,India,REGALIX INC,APAC,2025-04-23,2,2,0,0,0
Google.org,India,COGNIZANT TECHNOLOGY SOLUTIONS CORPORATION,APAC,2025-04-30,4,6,0,0,0
Technical Infrastructure,United States,"BARRY-WEHMILLER DESIGN GROUP, INC.",NORTH AMERICA,2025-04-30,16,2,14,0,14
Technical Infrastructure,Indonesia,G4S PLC,APAC,2025-04-23,2,4,0,0,0
T&S,India,ACCENTURE PLC,APAC,2025-04-24,2,1,1,0,1
T&S,India,WIPRO LIMITED,APAC,2025-05-01,4,5,1,1,0
Access,United States,HR GREEN INC,NORTH AMERICA,2025-04-30,5,2,3,1,2
Technical Infrastructure,United Kingdom,ARCADIS NV,EMEA,2025-04-24,2,1,1,1,0
Technical Infrastructure,null,EXYTE GMBH,EMEA,2025-05-02,3,3,0,0,0
gTech,United States,TECH MAHINDRA LIMITED,NORTH AMERICA,2025-04-23,5,5,2,0,2
REWS,India,SODEXO,APAC,2025-04-22,1,1,0,0,0
Platforms + Ecosystems,United States,WIPRO LIMITED,NORTH AMERICA,2025-04-30,3,5,0,0,0
REWS,United States,JONES LANG LASALLE INC,NORTH AMERICA,2025-04-29,4,5,1,0,1
Learning and Sustainability,United States,LEFT FIELD LABS LLC,NORTH AMERICA,2025-04-30,16,3,13,0,13
gTech,India,VIRTUSA CORPORATION,APAC,2025-04-25,3,3,0,0,0
Ads & Commerce,Philippines,ACCENTURE PLC,APAC,2025-04-24,5,1,4,1,3
Cloud,India,INFOSYS,APAC,2025-04-21,4,1,3,1,2
REWS,India,JONES LANG LASALLE INC,APAC,2025-05-02,3,3,0,0,0
Technical Infrastructure,United States,SYNCREON GLOBAL HOLDINGS LIMITED,NORTH AMERICA,2025-04-21,4,3,1,1,0
Technical Infrastructure,Finland,FIBER HIGHWAY FINLAND OY,EMEA,2025-04-28,2,4,0,0,0
REWS,India,JONES LANG LASALLE INC,APAC,2025-04-22,1,1,0,0,0
Devices & Services,null,QUEST GLOBAL SERVICES PTE. LTD.,NORTH AMERICA,2025-04-24,3,3,0,0,0
REWS,United States,GARDA WORLD SECURITY CORPORATION,NORTH AMERICA,2025-04-24,2,1,1,1,0
POps,Brazil,MARSH & MCLENNAN COMPANIES INC,LATAM,2025-04-24,6,5,3,0,3
REWS,India,SODEXO,APAC,2025-04-22,1,1,0,0,0
Cloud,El Salvador,TELUS,LATAM,2025-05-02,6,6,2,0,2
Technical Infrastructure,United States,ALLIED UNIVERSAL,NORTH AMERICA,2025-04-22,3,4,1,0,1
YouTube,India,ACCENTURE PLC,APAC,2025-04-24,5,1,4,1,3
T&S,India,ACCENTURE PLC,APAC,2025-04-21,4,1,3,1,2
YouTube,India,CONCENTRIX,APAC,2025-04-22,5,2,3,2,1
Technical Infrastructure,United States,MCFARLAND BUILDING GROUP LLC,NORTH AMERICA,2025-05-01,3,3,0,0,0
gTech,Germany,VACO,EMEA,2025-04-21,3,5,0,0,0
REWS,United States,SYNERGY GLOBAL HOUSING LLC,NORTH AMERICA,2025-04-22,5,2,3,3,0
Technical Infrastructure,United States,SCHENKER,NORTH AMERICA,2025-04-24,11,7,6,5,1
Technical Infrastructure,United States,DIRECT LINE GLOBAL LLC,NORTH AMERICA,2025-04-25,4,4,0,0,0
REWS,null,COMPASS GROUP PLC,NORTH AMERICA,2025-04-25,3,3,0,0,0
Technical Infrastructure,United States,AMENTUM COMMERCIAL OPERATIONS INC,NORTH AMERICA,2025-04-22,4,6,0,0,0
Platforms + Ecosystems,United States,LAWYERS ON DEMAND LIMITED,NORTH AMERICA,2025-04-22,3,5,0,0,0
Technical Infrastructure,United States,ASTREYA PARTNERS INC,NORTH AMERICA,2025-04-21,3,1,2,2,0
Technical Infrastructure,Finland,FIBER HIGHWAY FINLAND OY,EMEA,2025-04-28,2,4,0,0,0
YouTube,India,CONCENTRIX,APAC,2025-04-23,5,2,3,0,3
YouTube,India,WIPRO LIMITED,APAC,2025-04-28,5,8,0,0,0
gTech,United States,VACO,NORTH AMERICA,2025-05-02,7,5,4,3,1
Cloud,United States,GENERAL DYNAMICS INFORMATION TECHNOLOGY,NORTH AMERICA,2025-04-22,5,3,2,1,1
Cloud,India,HCL TECHNOLOGIES LTD,APAC,2025-04-21,5,4,1,0,1
T&S,India,WIPRO LIMITED,APAC,2025-05-02,4,2,2,0,2
gTech,India,VACO,APAC,2025-04-30,3,5,0,0,0
gCS,Malaysia,TELEDIRECT PTE LTD,APAC,2025-04-24,5,5,2,1,1
REWS,Japan,COMPASS GROUP PLC,APAC,2025-04-25,3,3,0,0,0
Technical Infrastructure,United States,ALLIED UNIVERSAL,NORTH AMERICA,2025-04-28,4,3,1,1,0
Technical Infrastructure,India,ACCENTURE PLC,APAC,2025-04-27,5,2,3,0,3
gTech,Philippines,TELUS,APAC,2025-04-29,7,4,5,4,1
T&S,India,CONCENTRIX,APAC,2025-04-28,1,3,0,0,0
Technical Infrastructure,null,THE WHITING TURNER CONTRACTING COMPANY,NORTH AMERICA,2025-04-28,3,5,0,0,0
YouTube,Malaysia,CONCENTRIX,APAC,2025-04-24,7,1,6,0,6
Cloud,India,EXIMIETAS DESIGN LLC,APAC,2025-04-24,2,1,1,1,0
REWS,United States,MCCUNE MANAGEMENT SERVICES LIMITED,NORTH AMERICA,2025-04-28,11,3,10,0,10
T&S,India,COGNIZANT TECHNOLOGY SOLUTIONS CORPORATION,APAC,2025-04-21,2,1,1,0,1
Technical Infrastructure,Netherlands,SECURITAS AB,EMEA,2025-04-30,5,2,3,2,1
REWS,India,JONES LANG LASALLE INC,APAC,2025-04-23,1,1,0,0,0
Waymo,United States,TRANSDEV,NORTH AMERICA,2025-04-24,7,3,4,1,3
Cloud,United States,"MAGNIT, LLC",NORTH AMERICA,2025-04-27,3,5,0,0,0
Devices & Services,India,VIRTUSA CORPORATION,APAC,2025-05-01,4,4,2,2,0
POps,Romania,ACCENTURE PLC,EMEA,2025-04-23,10,9,3,3,0
T&S,Philippines,ACCENTURE PLC,APAC,2025-04-29,10,3,7,0,7
REWS,India,JONES LANG LASALLE INC,APAC,2025-05-02,3,3,0,0,0
T&S,India,ACCENTURE PLC,APAC,2025-04-28,4,1,3,2,1
gCS,Brazil,TTEC HOLDINGS INC,LATAM,2025-04-23,6,1,5,1,4
REWS,United States,CBRE GROUP INC,NORTH AMERICA,2025-04-23,10,5,7,0,7
Technical Infrastructure,United States,J E DUNN CONSTRUCTION COMPANY,NORTH AMERICA,2025-04-25,2,2,0,0,0
Waymo,United States,AUTONATION,NORTH AMERICA,2025-04-21,2,1,1,0,1
Technical Infrastructure,United States,"HOLDER CONSTRUCTION GROUP, LLC",NORTH AMERICA,2025-05-01,3,3,0,0,0
YouTube,Philippines,COGNIZANT TECHNOLOGY SOLUTIONS CORPORATION,APAC,2025-05-02,3,3,0,0,0
Devices & Services,India,HCL TECHNOLOGIES LTD,APAC,2025-04-23,2,2,0,0,0
REWS,Australia,FIRST,APAC,2025-04-21,2,1,1,0,1
HUE,Colombia,HUGE LLC,LATAM,2025-04-25,11,7,6,0,6
Global Affairs (w/o T&S),United States,"ELEVATE SERVICES, INC.",NORTH AMERICA,2025-04-28,14,6,10,0,10
REWS,United States,COMPASS GROUP PLC,NORTH AMERICA,2025-05-01,3,3,0,0,0
Technical Infrastructure,India,ACCENTURE PLC,APAC,2025-04-21,7,1,6,0,6
REWS,null,SODEXO,NORTH AMERICA,2025-04-28,3,5,0,0,0
Waymo,United States,METRO ONE LOSS PREVENTION SERVICES GROUP (GUARD DIVISION) INC,NORTH AMERICA,2025-04-28,5,3,2,1,1
REWS,United States,GARDA WORLD SECURITY CORPORATION,NORTH AMERICA,2025-04-21,8,5,5,0,5
YouTube,India,ACCENTURE PLC,APAC,2025-04-21,7,4,5,0,5
Corp Eng,United States,SAP SE,NORTH AMERICA,2025-04-28,39,2,37,12,25
gTech,Philippines,TELUS,APAC,2025-04-27,6,4,4,4,0
GBO (w/o gTech & gCS),India,ACCENTURE PLC,APAC,2025-04-24,3,1,2,0,2
T&S,Portugal,ACCENTURE PLC,EMEA,2025-04-24,7,2,5,2,3
Technical Infrastructure,null,"HOLDER CONSTRUCTION GROUP, LLC",NORTH AMERICA,2025-04-21,3,5,0,0,0
gTech,India,HCL TECHNOLOGIES LTD,APAC,2025-04-22,8,4,6,0,6
Waymo,India,WIPRO LIMITED,APAC,2025-04-28,4,1,3,0,3
REWS,Taiwan,"LIANG PIN DINING CO., LTD.",APAC,2025-05-02,3,3,0,0,0
Geo,India,WIPRO LIMITED,APAC,2025-04-28,0,1,0,0,0
Devices & Services,Taiwan,WIPRO LIMITED,APAC,2025-04-23,2,1,1,0,1
Waymo,India,COGNIZANT TECHNOLOGY SOLUTIONS CORPORATION,APAC,2025-04-21,1,3,0,0,0
Waymo,United States,TRANSDEV,NORTH AMERICA,2025-04-24,7,3,4,1,3
Technical Infrastructure,United States,GXO LOGISTICS WORLDWIDE LLC,NORTH AMERICA,2025-04-24,2,2,0,0,0
REWS,United States,SYSTEM ONE HOLDINGS LLC DBA TEAMPEOPLE,NORTH AMERICA,2025-04-29,3,5,0,0,0
gTech,Greece,TELEPERFORMANCE SE,EMEA,2025-04-28,7,8,1,1,0
YouTube,Portugal,GENPACT LIMITED,EMEA,2025-04-22,4,2,2,1,1
Technical Infrastructure,United States,SYNCREON GLOBAL HOLDINGS LIMITED,NORTH AMERICA,2025-04-30,3,3,2,1,1
gTech,India,VIRTUSA CORPORATION,APAC,2025-04-25,3,3,0,0,0
Technical Infrastructure,United States,GXO LOGISTICS WORLDWIDE LLC,NORTH AMERICA,2025-04-28,2,4,0,0,0
Technical Infrastructure,Singapore,LANTROVISION (S) LTD,APAC,2025-04-27,12,5,9,9,0
Devices & Services,United States,"SYNOPSYS, INC",NORTH AMERICA,2025-04-25,4,3,1,1,0
T&S,India,WIPRO LIMITED,APAC,2025-04-25,3,1,2,0,2
Devices & Services,United States,"AKRAYA, INC",NORTH AMERICA,2025-05-02,4,3,1,0,1
Cloud,El Salvador,SERVICESOURCE INTERNATIONAL INC,LATAM,2025-04-28,3,5,0,0,0
Waymo,India,WIPRO LIMITED,APAC,2025-04-27,4,1,3,0,3
Corp Eng,United States,ONE DIVERSIFIED LLC,NORTH AMERICA,2025-04-25,2,2,0,0,0
T&S,Philippines,ACCENTURE PLC,APAC,2025-04-29,10,3,7,0,7
Technical Infrastructure,Netherlands,DVR GROUP HOLDING BV,EMEA,2025-04-22,7,3,6,3,3
Platforms + Ecosystems,India,DELOITTE,APAC,2025-04-28,5,4,1,1,0
Cloud,India,EPAM SYSTEMS INC,APAC,2025-04-23,4,4,2,1,1
Cloud,India,EPAM SYSTEMS INC,APAC,2025-04-27,6,4,4,1,3
Cloud,India,COGNIZANT TECHNOLOGY SOLUTIONS CORPORATION,APAC,2025-05-01,5,5,2,1,1
gCS,India,WNS (HOLDINGS) LIMITED,APAC,2025-04-24,3,1,2,1,1
POps,India,RANDSTAD NV,APAC,2025-05-02,7,2,5,1,4
Geo,India,TECH MAHINDRA LIMITED,APAC,2025-04-30,4,5,1,1,0
gTech,Poland,TELEPERFORMANCE SE,EMEA,2025-04-28,3,5,0,0,0
REWS,null,ARAMARK HOLDINGS CORPORATION,NORTH AMERICA,2025-04-25,3,3,0,0,0
Access,United States,"ROCKY MOUNTAIN WEST TELECOM, INC.",NORTH AMERICA,2025-04-25,17,5,14,1,13
Cloud,Philippines,ACCENTURE PLC,APAC,2025-05-01,5,6,1,0,1
T&S,Ireland,ACCENTURE PLC,EMEA,2025-04-23,5,2,3,0,3
REWS,India,JONES LANG LASALLE INC,APAC,2025-04-22,1,1,0,0,0
REWS,null,SODEXO,APAC,2025-05-02,3,3,0,0,0
Technical Infrastructure,Brazil,FLEX LTD,LATAM,2025-04-22,8,5,5,2,3
T&S,Philippines,ACCENTURE PLC,APAC,2025-04-28,3,5,0,0,0
Cloud,United States,TELOS CORPORATION,NORTH AMERICA,2025-04-28,4,2,2,0,2
gTech,India,VIRTUSA CORPORATION,APAC,2025-04-25,3,3,0,0,0
Technical Infrastructure,United States,GARDA WORLD SECURITY CORPORATION,NORTH AMERICA,2025-04-22,6,2,4,3,1
Cloud,United States,UJET INC,NORTH AMERICA,2025-04-29,2,4,0,0,0
Cloud,India,PERSISTENT SYSTEMS LIMITED,APAC,2025-04-21,3,1,2,1,1
Cloud,India,COGNIZANT TECHNOLOGY SOLUTIONS CORPORATION,APAC,2025-04-21,1,3,0,0,0
REWS,United States,JONES LANG LASALLE INC,NORTH AMERICA,2025-04-23,3,5,0,0,0
GBO (w/o gTech & gCS),United States,TIER1 IMPACT PBC INC DBA TIER1 PERFORMANCE,NORTH AMERICA,2025-04-24,5,4,3,1,2
Platforms + Ecosystems,South Korea,COGNIZANT TECHNOLOGY SOLUTIONS CORPORATION,APAC,2025-04-24,3,1,2,0,2
Geo,null,PWC,NORTH AMERICA,2025-05-02,3,3,0,0,0
Cloud,United States,UBER TECHNOLOGIES INC,NORTH AMERICA,2025-04-23,4,4,2,2,0
POps,India,KORN FERRY INTERNATIONAL,APAC,2025-05-01,5,4,3,2,1
gTech,India,COGNIZANT TECHNOLOGY SOLUTIONS CORPORATION,APAC,2025-04-29,3,5,0,0,0
REWS,India,SODEXO,APAC,2025-05-02,3,3,0,0,0
REWS,India,MEDIFIT CONSULTANTS PVT LTD,APAC,2025-04-24,1,1,0,0,0
Cloud,United States,ICONMA LLC,NORTH AMERICA,2025-05-01,9,14,2,2,0
Technical Infrastructure,United States,GARDA WORLD SECURITY CORPORATION,NORTH AMERICA,2025-05-02,4,3,1,1,0
Marketing,Mexico,FIREWOOD MARKETING INC.,LATAM,2025-04-30,12,2,10,0,10
YouTube,India,CONCENTRIX,APAC,2025-04-25,7,1,6,0,6
Ads & Commerce,Poland,TELUS,EMEA,2025-04-30,4,5,1,0,1
Cloud,India,HCL TECHNOLOGIES LTD,APAC,2025-04-29,1,1,0,0,0
T&S,Malaysia,ACCENTURE PLC,APAC,2025-04-29,2,3,1,0,1
Technical Infrastructure,United States,GXO LOGISTICS WORLDWIDE LLC,NORTH AMERICA,2025-04-24,2,2,0,0,0
Technical Infrastructure,Poland,EPAM SYSTEMS INC,EMEA,2025-05-02,3,3,0,0,0
Technical Infrastructure,United States,GXO LOGISTICS WORLDWIDE LLC,NORTH AMERICA,2025-04-28,4,2,2,1,1
Technical Infrastructure,Japan,"EXECUTIVE PROTECTION, INC.",APAC,2025-04-23,3,3,2,2,0
Waymo,United States,TRANSDEV,NORTH AMERICA,2025-04-23,16,3,13,13,0
Geo,India,ACCENTURE PLC,APAC,2025-05-02,6,4,4,0,4
T&S,India,WIPRO LIMITED,APAC,2025-05-01,4,5,1,0,1
gCS,Spain,TELEPERFORMANCE SE,EMEA,2025-04-21,7,6,3,1,2
YouTube,India,CONCENTRIX,APAC,2025-05-01,3,1,2,2,0
Waymo,United States,AMERIT FLEET SOLUTIONS INC.,NORTH AMERICA,2025-04-29,2,4,0,0,0
Technical Infrastructure,null,EVERGREEN JANITORIAL SERVICES INC,NORTH AMERICA,2025-04-25,3,3,0,0,0
gCS,Spain,TELEPERFORMANCE SE,EMEA,2025-05-01,7,1,6,5,1
Technical Infrastructure,United States,C D MOODY CONSTRUCTION COMPANY INC,NORTH AMERICA,2025-04-24,3,3,0,0,0
gTech,Malaysia,CONCENTRIX,APAC,2025-04-21,3,5,0,0,0
Waymo,India,WIPRO LIMITED,APAC,2025-04-24,3,3,1,1,0
REWS,India,JONES LANG LASALLE INC,APAC,2025-04-22,1,1,0,0,0
Waymo,India,COGNIZANT TECHNOLOGY SOLUTIONS CORPORATION,APAC,2025-04-24,2,1,1,0,1
Waymo,India,WIPRO LIMITED,APAC,2025-04-30,6,1,5,0,5
YouTube,India,GENPACT LIMITED,APAC,2025-04-28,3,2,1,0,1
Technical Infrastructure,United Kingdom,SYNERGY SECURITY SOLUTIONS LIMITED,EMEA,2025-04-30,2,3,0,0,0
gTech,India,ACCENTURE PLC,APAC,2025-04-21,3,2,1,1,0
Technical Infrastructure,India,INDIGO TELECOM GROUP LTD,APAC,2025-05-01,3,3,0,0,0
REWS,India,JONES LANG LASALLE INC,APAC,2025-04-23,1,1,0,0,0
Waymo,India,COGNIZANT TECHNOLOGY SOLUTIONS CORPORATION,APAC,2025-04-21,1,3,0,0,0
REWS,Colombia,G4S PLC,LATAM,2025-04-25,3,3,0,0,0
gCS,India,ACCENTURE PLC,APAC,2025-04-23,6,2,4,4,0
Waymo,India,WIPRO LIMITED,APAC,2025-05-01,3,2,1,1,0
Cloud,Israel,COGNIZANT TECHNOLOGY SOLUTIONS CORPORATION,EMEA,2025-04-22,11,3,8,8,0
Technical Infrastructure,United States,SYNCREON GLOBAL HOLDINGS LIMITED,NORTH AMERICA,2025-04-29,6,2,4,3,1
T&S,India,ACCENTURE PLC,APAC,2025-04-29,4,2,2,0,2
Technical Infrastructure,United States,DIRECT LINE GLOBAL LLC,NORTH AMERICA,2025-04-28,1,3,0,0,0
Waymo,United States,METRO ONE LOSS PREVENTION SERVICES GROUP (GUARD DIVISION) INC,NORTH AMERICA,2025-04-25,11,4,9,4,5
YouTube,India,CONCENTRIX,APAC,2025-04-22,13,5,10,9,1
Technical Infrastructure,United States,SCHENKER,NORTH AMERICA,2025-04-22,5,2,3,0,3
gTech,India,GENPACT LIMITED,APAC,2025-04-21,2,1,1,1,0
Technical Infrastructure,Belgium,TRACTEBEL ENGINEERING SA/NV,EMEA,2025-04-29,4,2,2,1,1
gTech,India,COGNIZANT TECHNOLOGY SOLUTIONS CORPORATION,APAC,2025-04-21,7,4,5,4,1
REWS,India,G4S PLC,APAC,2025-04-24,1,1,0,0,0
Technical Infrastructure,United States,SCHENKER,NORTH AMERICA,2025-04-25,8,2,6,4,2
REWS,India,JONES LANG LASALLE INC,APAC,2025-05-02,3,3,0,0,0
POps,India,RANDSTAD NV,APAC,2025-04-24,6,2,4,0,4
Technical Infrastructure,null,ERICSSON INC,EMEA,2025-05-01,3,3,0,0,0
REWS,null,JONES LANG LASALLE INC,APAC,2025-04-25,3,3,0,0,0
YouTube,India,WIPRO LIMITED,APAC,2025-05-02,3,3,0,0,0
Marketing,United States,INSIGHT,NORTH AMERICA,2025-04-25,4,2,2,0,2
gTech,India,TELEPERFORMANCE SE,APAC,2025-04-28,3,5,0,0,0
Technical Infrastructure,United States,ALLIED UNIVERSAL,NORTH AMERICA,2025-04-28,4,2,2,1,1
YouTube,Philippines,CONCENTRIX,APAC,2025-04-23,6,3,3,3,0
T&S,India,COGNIZANT TECHNOLOGY SOLUTIONS CORPORATION,APAC,2025-04-28,5,2,3,0,3
POps,India,RANDSTAD NV,APAC,2025-04-28,12,4,10,3,7
Platforms + Ecosystems,Philippines,ACCENTURE PLC,APAC,2025-05-02,3,3,0,0,0
REWS,India,JONES LANG LASALLE INC,APAC,2025-04-23,1,1,0,0,0
Technical Infrastructure,United States,"T5 DCMC, LLC",NORTH AMERICA,2025-05-02,4,3,1,1,0
Platforms + Ecosystems,Philippines,ACCENTURE PLC,APAC,2025-04-30,5,6,1,1,0
Technical Infrastructure,United States,J E DUNN CONSTRUCTION COMPANY,NORTH AMERICA,2025-04-30,3,5,0,0,0
Cloud,Philippines,ACCENTURE PLC,APAC,2025-04-25,4,1,3,3,0
Marketing,Czech Republic,ARTERIA SA,EMEA,2025-04-24,3,3,0,0,0
Global Affairs (w/o T&S),United Arab Emirates,MANPOWERGROUP INC,EMEA,2025-04-23,14,11,7,2,5
gTech,Philippines,TELUS,APAC,2025-04-22,2,4,0,0,0
Technical Infrastructure,Chile,PROSEGUR SA,LATAM,2025-04-24,15,5,12,11,1
gTech,India,COGNIZANT TECHNOLOGY SOLUTIONS CORPORATION,APAC,2025-05-01,3,3,0,0,0
REWS,India,JONES LANG LASALLE INC,APAC,2025-05-02,3,3,0,0,0
Technical Infrastructure,United States,ACCENTURE PLC,NORTH AMERICA,2025-04-21,3,2,1,0,1
DeepMind,United States,SCALE AI INC,NORTH AMERICA,2025-04-24,18,3,15,14,1
Cloud,India,COGNIZANT TECHNOLOGY SOLUTIONS CORPORATION,APAC,2025-04-24,2,2,0,0,0
T&S,Philippines,ACCENTURE PLC,APAC,2025-04-29,10,3,7,0,7
gTech,null,TELEPERFORMANCE SE,EMEA,2025-04-28,3,5,0,0,0
Finance,India,EPAM SYSTEMS INC,APAC,2025-04-25,2,2,0,0,0
Waymo,India,WIPRO LIMITED,APAC,2025-04-24,3,4,0,0,0
Waymo,United States,TRANSDEV,NORTH AMERICA,2025-04-24,7,2,5,2,3
REWS,India,COMPASS GROUP PLC,APAC,2025-04-25,2,2,0,0,0
Cloud,United States,"TRIPLE CROWN CONSULTING, LLC",NORTH AMERICA,2025-04-24,4,5,1,0,1
Cloud,India,INFOSYS,APAC,2025-04-22,2,3,1,0,1
Technical Infrastructure,United States,SCHENKER,NORTH AMERICA,2025-04-29,1,1,0,0,0
Waymo,United States,"TASKUS, INC.",NORTH AMERICA,2025-05-02,4,2,2,1,1
Ads & Commerce,India,GLOBALLOGIC INC,APAC,2025-04-29,1,1,0,0,0
YouTube,India,TELEPERFORMANCE SE,APAC,2025-04-23,5,5,2,2,0
gCS,Canada,TELEPERFORMANCE SE,NORTH AMERICA,2025-05-01,6,2,4,1,3
Cloud,Philippines,ACCENTURE PLC,APAC,2025-04-27,5,2,3,3,0
Corp Eng,India,ASTREYA PARTNERS INC,APAC,2025-04-24,6,null,6,1,5
Waymo,India,COGNIZANT TECHNOLOGY SOLUTIONS CORPORATION,APAC,2025-04-28,2,4,0,0,0
Technical Infrastructure,United States,"HOLDER CONSTRUCTION GROUP, LLC",NORTH AMERICA,2025-05-02,3,3,0,0,0
Technical Infrastructure,United States,"ROONEY HOLDINGS, INC.",NORTH AMERICA,2025-05-01,3,3,0,0,0
T&S,India,WIPRO LIMITED,APAC,2025-04-25,2,2,0,0,0
POps,India,RANDSTAD NV,APAC,2025-04-24,17,3,14,2,12
Technical Infrastructure,United States,SCHENKER,NORTH AMERICA,2025-04-23,7,1,6,0,6
gTech,India,COGNIZANT TECHNOLOGY SOLUTIONS CORPORATION,APAC,2025-04-22,3,1,2,1,1
Technical Infrastructure,Netherlands,SYNCREON GLOBAL HOLDINGS LIMITED,EMEA,2025-04-29,5,3,2,1,1
Cloud,Mexico,TATA GROUP,LATAM,2025-04-27,4,1,3,2,1
T&S,Poland,ACCENTURE PLC,EMEA,2025-04-22,7,4,5,3,2
Technical Infrastructure,United States,GXO LOGISTICS WORLDWIDE LLC,NORTH AMERICA,2025-04-25,6,4,4,0,4
POps,India,DELOITTE,APAC,2025-04-28,3,5,0,0,0
gCS,India,REGALIX INC,APAC,2025-04-24,3,3,0,0,0
gCS,India,ACCENTURE PLC,APAC,2025-04-28,5,2,3,0,3
YouTube,India,WIPRO LIMITED,APAC,2025-04-23,34,1,33,1,32
Technical Infrastructure,United States,MC DEAN INC,NORTH AMERICA,2025-04-30,4,4,2,2,0
Waymo,United States,TRANSDEV,NORTH AMERICA,2025-04-24,7,3,4,4,0
Technical Infrastructure,United States,C D MOODY CONSTRUCTION COMPANY INC,NORTH AMERICA,2025-04-24,3,3,0,0,0
Technical Infrastructure,United States,GXO LOGISTICS WORLDWIDE LLC,NORTH AMERICA,2025-04-28,18,5,15,5,10
Finance,Argentina,ACCENTURE PLC,LATAM,2025-04-25,9,10,1,0,1
REWS,India,JONES LANG LASALLE INC,APAC,2025-04-23,2,2,0,0,0
YouTube,India,ACCENTURE PLC,APAC,2025-04-24,11,1,10,0,10
T&S,India,WIPRO LIMITED,APAC,2025-04-29,6,2,4,4,0
T&S,India,CONCENTRIX,APAC,2025-04-29,2,3,1,0,1
Access,India,QUANTIPHI INC,APAC,2025-04-24,4,4,2,2,0
T&S,India,WIPRO LIMITED,APAC,2025-05-01,4,5,1,1,0
Waymo,United States,TRANSDEV,NORTH AMERICA,2025-04-24,7,2,5,2,3
gTech,India,TECH MAHINDRA LIMITED,APAC,2025-04-27,3,2,1,1,0
T&S,India,WIPRO LIMITED,APAC,2025-04-30,3,5,0,0,0
T&S,Poland,ACCENTURE PLC,EMEA,2025-04-30,5,5,2,2,0
Ads & Commerce,India,"APPLAUSE APP QUALITY, INC",APAC,2025-04-28,5,5,1,1,0
YouTube,India,TATA GROUP,APAC,2025-04-29,4,6,0,0,0
Waymo,United States,METRO ONE LOSS PREVENTION SERVICES GROUP (GUARD DIVISION) INC,NORTH AMERICA,2025-04-25,4,2,2,0,2
gTech,Philippines,TELUS,APAC,2025-04-24,4,4,2,0,2
gTech,India,TELEPERFORMANCE SE,APAC,2025-04-22,5,1,4,1,3
T&S,India,COGNIZANT TECHNOLOGY SOLUTIONS CORPORATION,APAC,2025-04-27,5,1,4,0,4
Platforms + Ecosystems,India,ITTIAM SYSTEMS PVT LTD,APAC,2025-04-28,6,5,3,0,3
Technical Infrastructure,United Kingdom,SUDLOWS ENTERPRISE SERVICES LIMITED,EMEA,2025-05-02,3,3,0,0,0
Waymo,India,WIPRO LIMITED,APAC,2025-04-21,2,1,1,1,0
POps,India,ACCENTURE PLC,APAC,2025-04-21,5,2,3,0,3
YouTube,India,ACCENTURE PLC,APAC,2025-04-21,6,3,5,0,5
Waymo,India,WIPRO LIMITED,APAC,2025-04-24,3,4,0,0,0
Access,United States,ALLO HOLDING LLC,NORTH AMERICA,2025-05-01,8,4,5,2,3
Technical Infrastructure,United States,SCHENKER,NORTH AMERICA,2025-04-25,3,3,0,0,0
Waymo,United States,KPMG,NORTH AMERICA,2025-04-30,3,3,2,0,2
HUE,Colombia,HUGE LLC,LATAM,2025-04-23,9,6,5,2,3
gCS,China,ACCENTURE PLC,APAC,2025-04-30,12,4,8,0,8
gTech,India,COGNIZANT TECHNOLOGY SOLUTIONS CORPORATION,APAC,2025-04-25,4,2,2,0,2
Cloud,Mexico,TATA GROUP,LATAM,2025-04-22,10,2,8,0,8
gTech,India,GENPACT LIMITED,APAC,2025-04-23,5,2,3,3,0
Ads & Commerce,Poland,TELUS,EMEA,2025-04-29,3,4,1,0,1
POps,India,RANDSTAD NV,APAC,2025-04-24,10,1,9,0,9
Technical Infrastructure,United States,CHURCHILL COST CONSULTANTS LLC,NORTH AMERICA,2025-05-02,3,3,0,0,0
Cloud,India,HCL TECHNOLOGIES LTD,APAC,2025-04-21,5,2,3,0,3
gTech,Poland,TELEPERFORMANCE SE,EMEA,2025-04-28,3,5,0,0,0
Technical Infrastructure,United States,GXO LOGISTICS WORLDWIDE LLC,NORTH AMERICA,2025-04-25,13,3,10,7,3
Technical Infrastructure,United States,"HOLDER CONSTRUCTION GROUP, LLC",NORTH AMERICA,2025-05-02,3,3,0,0,0
Cloud,India,BRISTLECONE INC.,APAC,2025-04-28,9,1,8,0,8
Corp Eng,India,ACCENTURE PLC,APAC,2025-04-22,3,1,2,0,2
POps,India,ACCENTURE PLC,APAC,2025-04-30,3,5,0,0,0
gTech,India,VIRTUSA CORPORATION,APAC,2025-04-25,3,3,0,0,0
gTech,Portugal,TELEPERFORMANCE SE,EMEA,2025-04-24,6,1,5,5,0
Geo,India,WIPRO LIMITED,APAC,2025-04-23,2,1,1,0,1
REWS,India,JONES LANG LASALLE INC,APAC,2025-05-02,3,3,0,0,0
REWS,India,JONES LANG LASALLE INC,APAC,2025-05-02,3,3,0,0,0
Technical Infrastructure,United States,MCFARLAND BUILDING GROUP LLC,NORTH AMERICA,2025-04-25,4,4,0,0,0
T&S,India,WIPRO LIMITED,APAC,2025-04-30,5,2,3,1,2
Technical Infrastructure,Ireland,ARCADIS NV,EMEA,2025-04-29,3,5,0,0,0
Technical Infrastructure,United States,"ROONEY HOLDINGS, INC.",NORTH AMERICA,2025-05-01,3,3,0,0,0
Access,United States,DYCOM INDUSTRIES,NORTH AMERICA,2025-04-29,11,2,9,0,9
Technical Infrastructure,United States,SCHENKER,NORTH AMERICA,2025-04-21,2,1,1,0,1
gCS,India,TELEDIRECT PTE LTD,APAC,2025-04-23,2,2,0,0,0
gTech,Ghana,MAJOREL GLOBAL,EMEA,2025-04-24,8,4,5,5,0
Waymo,United States,METRO ONE LOSS PREVENTION SERVICES GROUP (GUARD DIVISION) INC,NORTH AMERICA,2025-04-22,8,5,5,0,5
REWS,Philippines,JONES LANG LASALLE INC,APAC,2025-05-01,3,3,0,0,0
gTech,India,TELEPERFORMANCE SE,APAC,2025-04-24,2,1,1,0,1
Technical Infrastructure,Finland,ADECCO GROUP AG,EMEA,2025-04-25,8,6,4,0,4
Technical Infrastructure,null,J E DUNN CONSTRUCTION COMPANY,NORTH AMERICA,2025-04-24,3,3,0,0,0
Corp Eng,India,IBM CORPORATION,APAC,2025-04-22,3,1,2,1,1
Search,India,GLOBALLOGIC INC,APAC,2025-05-01,2,3,0,0,0
POps,India,ACCENTURE PLC,APAC,2025-04-29,5,2,3,1,2
REWS,null,JONES LANG LASALLE INC,APAC,2025-05-02,3,3,0,0,0
Waymo,India,WIPRO LIMITED,APAC,2025-04-27,5,4,2,2,0
Technical Infrastructure,Netherlands,SYNCREON GLOBAL HOLDINGS LIMITED,EMEA,2025-04-22,7,3,6,2,4
Technical Infrastructure,Belgium,GXO LOGISTICS WORLDWIDE LLC,EMEA,2025-04-25,3,2,1,1,0
Technical Infrastructure,Netherlands,TURNER & TOWNSEND PARTNERS LLP,EMEA,2025-04-23,4,5,1,0,1
T&S,India,WIPRO LIMITED,APAC,2025-05-02,3,3,0,0,0
Cloud,United States,UBER TECHNOLOGIES INC,NORTH AMERICA,2025-04-22,7,3,6,0,6
Cloud,India,INFOSYS,APAC,2025-04-29,12,5,9,8,1
DeepMind,United States,SCALE AI INC,NORTH AMERICA,2025-04-22,19,2,17,7,10
YouTube,India,GENPACT LIMITED,APAC,2025-04-25,2,2,0,0,0
Cloud,United Kingdom,ACCENTURE PLC,EMEA,2025-04-21,9,1,8,0,8
YouTube,Portugal,COGNIZANT TECHNOLOGY SOLUTIONS CORPORATION,EMEA,2025-04-23,7,3,4,3,1
Technical Infrastructure,United States,THE WHITING TURNER CONTRACTING COMPANY,NORTH AMERICA,2025-04-22,3,5,0,0,0
Technical Infrastructure,United States,GXO LOGISTICS WORLDWIDE LLC,NORTH AMERICA,2025-04-27,7,4,5,0,5
Ads & Commerce,Poland,TELUS,EMEA,2025-04-28,2,4,0,0,0
T&S,Philippines,ACCENTURE PLC,APAC,2025-05-02,7,2,5,4,1
Technical Infrastructure,United Kingdom,CBRE GROUP INC,EMEA,2025-04-28,7,1,6,2,4
Waymo,India,WIPRO LIMITED,APAC,2025-04-23,7,2,5,5,0
Waymo,India,WIPRO LIMITED,APAC,2025-04-30,6,1,5,5,0
T&S,India,ACCENTURE PLC,APAC,2025-04-28,4,3,1,1,0
T&S,India,COGNIZANT TECHNOLOGY SOLUTIONS CORPORATION,APAC,2025-04-25,4,1,3,0,3
Access,United States,"GLOBAL OPTICS SAN ANTONIO, L.P.",NORTH AMERICA,2025-04-21,8,2,6,5,1
T&S,India,WIPRO LIMITED,APAC,2025-04-28,4,3,1,0,1
gTech,India,VIRTUSA CORPORATION,APAC,2025-04-25,3,2,1,0,1
Cloud,Brazil,ACCENTURE PLC,LATAM,2025-04-22,4,2,2,2,0
gCS,Spain,TELEPERFORMANCE SE,EMEA,2025-04-22,8,5,5,5,0
Technical Infrastructure,United States,SCHENKER,NORTH AMERICA,2025-04-24,4,4,2,1,1
Waymo,Belgium,LS EUROPE LOGOS,EMEA,2025-05-02,8,3,5,1,4
gTech,United States,"MAGNIT, LLC",NORTH AMERICA,2025-04-21,18,2,18,18,0
Waymo,India,WIPRO LIMITED,APAC,2025-04-28,5,2,4,4,0
REWS,United States,ELECTROSONIC LIMITED,NORTH AMERICA,2025-04-25,2,2,0,0,0
T&S,India,WIPRO LIMITED,APAC,2025-04-30,3,5,0,0,0
REWS,India,COMPASS GROUP PLC,APAC,2025-05-01,3,3,0,0,0
T&S,Philippines,ACCENTURE PLC,APAC,2025-05-02,7,2,5,1,4
Technical Infrastructure,United States,ALLIED UNIVERSAL,NORTH AMERICA,2025-04-24,3,2,1,1,0
Technical Infrastructure,United States,GXO LOGISTICS WORLDWIDE LLC,NORTH AMERICA,2025-04-24,2,2,0,0,0
gTech,India,VIRTUSA CORPORATION,APAC,2025-04-29,5,2,3,2,1
T&S,India,WIPRO LIMITED,APAC,2025-04-27,11,3,10,10,0
gTech,Germany,VACO,EMEA,2025-04-27,3,2,1,0,1
gTech,Poland,TELEPERFORMANCE SE,EMEA,2025-04-21,3,5,0,0,0
Technical Infrastructure,United States,ALLIED UNIVERSAL,NORTH AMERICA,2025-04-23,2,2,0,0,0
Ads & Commerce,India,GLOBALLOGIC INC,APAC,2025-04-29,1,1,0,0,0
Devices & Services,null,QUEST GLOBAL SERVICES PTE. LTD.,APAC,2025-04-21,3,5,0,0,0
Cloud,El Salvador,TELUS,LATAM,2025-04-30,2,2,0,0,0
Technical Infrastructure,null,J E DUNN CONSTRUCTION COMPANY,NORTH AMERICA,2025-05-02,3,3,0,0,0
REWS,Peru,PROSEGUR SA,LATAM,2025-04-25,2,2,0,0,0
Waymo,India,COGNIZANT TECHNOLOGY SOLUTIONS CORPORATION,APAC,2025-04-27,4,1,3,3,0
Search,India,"TASKUS, INC.",APAC,2025-04-22,3,1,2,1,1
T&S,India,WIPRO LIMITED,APAC,2025-04-30,3,3,2,0,2
REWS,India,JONES LANG LASALLE INC,APAC,2025-05-02,3,3,0,0,0
Technical Infrastructure,Finland,CBRE GROUP INC,EMEA,2025-05-01,4,6,0,0,0
gTech,India,VIRTUSA CORPORATION,APAC,2025-04-25,3,3,0,0,0
T&S,India,WIPRO LIMITED,APAC,2025-04-23,4,4,2,0,2
Access,United States,IBEX HOLDINGS LIMITED,NORTH AMERICA,2025-04-22,3,1,2,0,2
Technical Infrastructure,United States,GARDA WORLD SECURITY CORPORATION,NORTH AMERICA,2025-05-01,3,1,2,0,2
REWS,India,JONES LANG LASALLE INC,APAC,2025-04-23,1,1,0,0,0
REWS,United States,COMPASS GROUP PLC,NORTH AMERICA,2025-05-01,3,3,0,0,0
Technical Infrastructure,United States,J E DUNN CONSTRUCTION COMPANY,NORTH AMERICA,2025-04-24,1,1,0,0,0
REWS,United States,GARDA WORLD SECURITY CORPORATION,NORTH AMERICA,2025-05-01,10,8,4,0,4
REWS,United States,COMPASS GROUP PLC,NORTH AMERICA,2025-04-22,1,1,0,0,0
Technical Infrastructure,null,AIDAN STRAIN ELECTRICAL ENGINEERING LIMITED,EMEA,2025-05-02,3,3,0,0,0
Cloud,Mexico,TATA GROUP,LATAM,2025-04-21,6,4,4,4,0
Cloud,India,EPAM SYSTEMS INC,APAC,2025-04-22,3,5,0,0,0
Technical Infrastructure,United States,GXO LOGISTICS WORLDWIDE LLC,NORTH AMERICA,2025-04-28,4,3,1,1,0
Technical Infrastructure,United States,SYNCREON GLOBAL HOLDINGS LIMITED,NORTH AMERICA,2025-04-29,3,5,0,0,0
Cloud,India,COGNIZANT TECHNOLOGY SOLUTIONS CORPORATION,APAC,2025-04-22,6,4,2,2,0
REWS,United States,COMPASS GROUP PLC,NORTH AMERICA,2025-04-24,3,3,0,0,0
gTech,Japan,GENPACT LIMITED,APAC,2025-04-24,3,2,1,0,1
Core (w/o Corp Eng),India,AD ASTRA STAFFING SOLUTIONS PVT. LTD.,APAC,2025-04-29,10,7,5,2,3
gTech,India,TELEPERFORMANCE SE,APAC,2025-04-22,5,1,4,4,0
Ads & Commerce,Philippines,ACCENTURE PLC,APAC,2025-04-30,9,1,8,6,2
Technical Infrastructure,null,C D MOODY CONSTRUCTION COMPANY INC,NORTH AMERICA,2025-04-28,3,5,0,0,0
REWS,United States,FLUXON APPS LLC,NORTH AMERICA,2025-04-25,8,1,7,7,0
Cloud,United States,HCL TECHNOLOGIES LTD,NORTH AMERICA,2025-04-27,5,2,3,0,3
Technical Infrastructure,null,INDIGO TELECOM GROUP LTD,LATAM,2025-05-01,3,3,0,0,0
Waymo,United States,UBER TECHNOLOGIES INC,NORTH AMERICA,2025-05-01,3,3,0,0,0
Platforms + Ecosystems,Philippines,ACCENTURE PLC,APAC,2025-04-24,2,1,1,0,1
YouTube,India,ACCENTURE PLC,APAC,2025-05-02,6,5,3,1,2
REWS,Ireland,FIRST,EMEA,2025-05-01,3,3,0,0,0
Technical Infrastructure,Chile,SISTEMAS CONTRA INCENDIOS EUROCOMERCIAL LTDA,LATAM,2025-04-28,3,5,0,0,0
Technical Infrastructure,null,"HOLDER CONSTRUCTION GROUP, LLC",NORTH AMERICA,2025-04-23,3,5,0,0,0
gCS,India,REGALIX INC,APAC,2025-04-25,4,3,1,1,0
Waymo,India,COGNIZANT TECHNOLOGY SOLUTIONS CORPORATION,APAC,2025-04-30,2,2,0,0,0
Technical Infrastructure,Finland,GXO LOGISTICS WORLDWIDE LLC,EMEA,2025-04-21,4,2,2,1,1
Technical Infrastructure,United States,GXO LOGISTICS WORLDWIDE LLC,NORTH AMERICA,2025-04-29,5,3,2,0,2
Waymo,United States,TRANSDEV,NORTH AMERICA,2025-05-01,7,6,3,1,2
Cloud,United States,COGNIZANT TECHNOLOGY SOLUTIONS CORPORATION,NORTH AMERICA,2025-04-21,2,1,1,0,1
Cloud,India,COGNIZANT TECHNOLOGY SOLUTIONS CORPORATION,APAC,2025-04-28,2,4,0,0,0
REWS,null,CBRE GROUP INC,NORTH AMERICA,2025-04-21,3,5,0,0,0
gTech,India,TELEPERFORMANCE SE,APAC,2025-04-22,5,3,2,0,2
Cloud,Philippines,COGNIZANT TECHNOLOGY SOLUTIONS CORPORATION,APAC,2025-04-25,4,1,3,0,3
gTech,India,TELEPERFORMANCE SE,APAC,2025-05-02,4,3,2,1,1
Waymo,United States,METRO ONE LOSS PREVENTION SERVICES GROUP (GUARD DIVISION) INC,NORTH AMERICA,2025-05-02,8,6,4,3,1
REWS,India,JONES LANG LASALLE INC,APAC,2025-04-23,2,2,0,0,0
Platforms + Ecosystems,United States,MAGIC LEAP INC.,NORTH AMERICA,2025-04-30,9,5,6,6,0
Waymo,India,WIPRO LIMITED,APAC,2025-04-24,3,2,2,2,0
Technical Infrastructure,null,SISTEMAS CONTRA INCENDIOS EUROCOMERCIAL LTDA,LATAM,2025-04-28,3,5,0,0,0
Devices & Services,United States,ARCHLYNK LLC,NORTH AMERICA,2025-05-02,5,4,3,0,3
Technical Infrastructure,United States,SYNCREON GLOBAL HOLDINGS LIMITED,NORTH AMERICA,2025-04-24,5,4,3,2,1
REWS,India,ANIXTER INC,APAC,2025-04-30,10,1,9,8,1
Waymo,India,WIPRO LIMITED,APAC,2025-05-01,3,3,0,0,0
Ads & Commerce,United States,"AKRAYA, INC",NORTH AMERICA,2025-04-22,3,5,0,0,0
YouTube,United States,TELEPERFORMANCE SE,NORTH AMERICA,2025-05-02,6,5,3,3,0
Corp Eng,India,ACCENTURE PLC,APAC,2025-04-29,6,1,5,0,5
REWS,India,JONES LANG LASALLE INC,APAC,2025-05-02,3,3,0,0,0
Finance,India,GEP WORLDWIDE,APAC,2025-04-24,2,1,1,1,0
gTech,Brazil,COGNIZANT TECHNOLOGY SOLUTIONS CORPORATION,LATAM,2025-04-22,4,1,3,0,3
Platforms + Ecosystems,India,ITTIAM SYSTEMS PVT LTD,APAC,2025-04-28,6,5,3,0,3
Technical Infrastructure,United States,UNIFY CONSULTING LLC,NORTH AMERICA,2025-05-01,3,3,0,0,0
Technical Infrastructure,United States,SCHENKER,NORTH AMERICA,2025-04-22,5,3,2,0,2
Ads & Commerce,Poland,TELUS,EMEA,2025-04-30,4,5,1,0,1
REWS,India,SODEXO,APAC,2025-04-22,1,1,0,0,0
Technical Infrastructure,United States,DIRECT LINE GLOBAL LLC,NORTH AMERICA,2025-04-24,1,1,0,0,0
YouTube,Poland,COGNIZANT TECHNOLOGY SOLUTIONS CORPORATION,EMEA,2025-05-02,4,3,1,0,1
gTech,India,VIRTUSA CORPORATION,APAC,2025-04-25,3,3,0,0,0
T&S,India,WIPRO LIMITED,APAC,2025-04-21,6,3,5,0,5
Marketing,Canada,DELOITTE,NORTH AMERICA,2025-05-02,4,1,3,2,1
Technical Infrastructure,United States,THE WHITING TURNER CONTRACTING COMPANY,NORTH AMERICA,2025-04-22,3,5,0,0,0
T&S,India,WIPRO LIMITED,APAC,2025-04-25,2,1,1,0,1
Devices & Services,India,QUEST GLOBAL SERVICES PTE. LTD.,APAC,2025-04-25,3,3,0,0,0
POps,India,RANDSTAD NV,APAC,2025-05-02,7,2,5,5,0
Corp Eng,Ireland,ASTREYA PARTNERS INC,EMEA,2025-05-01,11,1,10,0,10
gTech,India,TELEPERFORMANCE SE,APAC,2025-04-21,4,1,3,0,3
Technical Infrastructure,United States,SCHENKER,NORTH AMERICA,2025-04-24,3,3,0,0,0
gTech,India,TELEPERFORMANCE SE,APAC,2025-04-21,5,3,2,2,0
Technical Infrastructure,United States,GXO LOGISTICS WORLDWIDE LLC,NORTH AMERICA,2025-05-01,7,3,4,4,0
gCS,Spain,TELEPERFORMANCE SE,EMEA,2025-04-22,8,5,5,5,0
gTech,India,TECH MAHINDRA LIMITED,APAC,2025-04-21,3,2,1,0,1
Access,United States,"PROJECT RESOURCES GROUP, INC.",NORTH AMERICA,2025-04-23,4,5,1,0,1
Ads & Commerce,United Kingdom,CONTINUUMGLOBAL INC,EMEA,2025-04-30,2,3,0,0,0
Technical Infrastructure,United States,GXO LOGISTICS WORLDWIDE LLC,NORTH AMERICA,2025-04-28,4,2,2,1,1
Technical Infrastructure,null,SCHENKER,NORTH AMERICA,2025-04-24,3,3,0,0,0
YouTube,India,ACCENTURE PLC,APAC,2025-04-21,6,3,5,1,4
POps,India,KORN FERRY INTERNATIONAL,APAC,2025-04-24,3,1,2,1,1
Corp Eng,India,IBM CORPORATION,APAC,2025-04-23,4,4,2,0,2
Waymo,India,COGNIZANT TECHNOLOGY SOLUTIONS CORPORATION,APAC,2025-04-23,3,5,0,0,0
REWS,Australia,CONTROL RISKS GROUP HOLDINGS LIMITED,APAC,2025-04-22,5,2,3,0,3
gTech,India,TELEPERFORMANCE SE,APAC,2025-04-24,7,3,4,4,0
Technical Infrastructure,India,INDIGO TELECOM GROUP LTD,APAC,2025-04-29,1,1,0,0,0
gTech,India,TELEPERFORMANCE SE,APAC,2025-04-21,4,2,2,0,2
gTech,India,HCL TECHNOLOGIES LTD,APAC,2025-05-01,7,2,5,0,5
REWS,null,COMPASS GROUP PLC,NORTH AMERICA,2025-05-01,3,3,0,0,0
gCS,India,WNS (HOLDINGS) LIMITED,APAC,2025-04-30,3,4,1,1,0
Waymo,India,WIPRO LIMITED,APAC,2025-04-30,6,2,4,4,0
Ads & Commerce,India,TELEPERFORMANCE SE,APAC,2025-04-23,5,2,3,0,3
Finance,India,KPMG,APAC,2025-04-24,2,2,0,0,0
Access,United States,"SYSTEM RESOURCES TELECOM, LLC (SRI)",NORTH AMERICA,2025-04-30,8,5,5,4,1
REWS,United States,PFC GROUP OF COMPANIES,NORTH AMERICA,2025-04-25,3,1,2,0,2
Cloud,Philippines,ACCENTURE PLC,APAC,2025-04-21,6,3,5,2,3
Global Affairs (w/o T&S),United States,"CONSILIO, INC",NORTH AMERICA,2025-04-25,6,1,5,0,5
Waymo,India,WIPRO LIMITED,APAC,2025-04-27,4,1,3,0,3
Technical Infrastructure,null,SATURN PARTNERS LLC,NORTH AMERICA,2025-04-24,3,3,0,0,0
Waymo,United States,TRANSDEV,NORTH AMERICA,2025-04-24,7,2,5,1,4
Technical Infrastructure,United States,BRISTLECONE INC.,NORTH AMERICA,2025-04-25,4,3,1,0,1
POps,India,RANDSTAD NV,APAC,2025-04-24,10,1,9,0,9
Technical Infrastructure,United Kingdom,SYNERGY SECURITY SOLUTIONS LIMITED,EMEA,2025-04-22,3,4,1,0,1
gCS,India,ACCENTURE PLC,APAC,2025-04-27,13,1,12,12,0
REWS,null,YARZIN SELLA MANAGEMENT AND HOLDINGS,EMEA,2025-05-02,3,3,0,0,0
Technical Infrastructure,null,"HOLDER CONSTRUCTION GROUP, LLC",NORTH AMERICA,2025-04-22,3,5,0,0,0
Devices & Services,India,MIRAFRA SOFTWARE TECHNOLOGIES PVT. LTD.,APAC,2025-04-29,4,5,1,0,1
REWS,Philippines,JONES LANG LASALLE INC,APAC,2025-04-24,2,2,0,0,0
Technical Infrastructure,United States,SCHENKER,NORTH AMERICA,2025-04-22,1,1,0,0,0
Cloud,Philippines,ACCENTURE PLC,APAC,2025-04-22,7,3,6,3,3
Platforms + Ecosystems,India,VACO,APAC,2025-04-25,9,3,6,6,0
REWS,United States,EXOS,NORTH AMERICA,2025-04-22,4,1,3,1,2
Corp Eng,India,HCL TECHNOLOGIES LTD,APAC,2025-04-29,2,4,0,0,0
gTech,India,TELEPERFORMANCE SE,APAC,2025-04-24,3,2,1,1,0
POps,Poland,RANDSTAD NV,EMEA,2025-04-28,9,2,7,3,4
gCS,Brazil,ATENTO S.A.,LATAM,2025-04-29,3,5,0,0,0
Devices & Services,India,HCL TECHNOLOGIES LTD,APAC,2025-04-23,2,2,0,0,0
Finance,Philippines,ACCENTURE PLC,APAC,2025-04-21,9,1,8,8,0
Technical Infrastructure,United States,GARDA WORLD SECURITY CORPORATION,NORTH AMERICA,2025-04-30,2,1,1,1,0
gTech,India,COGNIZANT TECHNOLOGY SOLUTIONS CORPORATION,APAC,2025-04-23,2,2,0,0,0
Ads & Commerce,India,GLOBALLOGIC INC,APAC,2025-04-27,5,1,4,0,4
gCS,India,WNS (HOLDINGS) LIMITED,APAC,2025-04-24,3,1,2,0,2
Geo,India,WIPRO LIMITED,APAC,2025-04-28,2,1,1,1,0
Technical Infrastructure,Brazil,DICON CONTABILIDADE LTDA,LATAM,2025-04-23,8,5,5,5,0
Waymo,India,COGNIZANT TECHNOLOGY SOLUTIONS CORPORATION,APAC,2025-04-28,2,4,0,0,0
Technical Infrastructure,null,"ROONEY HOLDINGS, INC.",NORTH AMERICA,2025-05-02,3,3,0,0,0
gCS,India,TELEDIRECT PTE LTD,APAC,2025-04-25,4,2,2,2,0
Corp Eng,United States,DELOITTE,NORTH AMERICA,2025-05-02,6,5,3,1,2
T&S,India,COGNIZANT TECHNOLOGY SOLUTIONS CORPORATION,APAC,2025-04-27,5,1,4,2,2
T&S,India,ACCENTURE PLC,APAC,2025-04-25,6,5,3,0,3
REWS,India,SODEXO,APAC,2025-04-22,1,1,0,0,0
Technical Infrastructure,United States,GARDA WORLD SECURITY CORPORATION,NORTH AMERICA,2025-04-24,10,5,7,6,1
REWS,South Korea,JONES LANG LASALLE INC,APAC,2025-05-02,3,3,0,0,0
Cloud,Spain,TELEPERFORMANCE SE,EMEA,2025-04-28,3,5,0,0,0
Technical Infrastructure,United States,EXPEDITORS INTERNATIONAL OF WASHINGTON INC,NORTH AMERICA,2025-04-28,3,2,1,1,0
Platforms + Ecosystems,India,ITTIAM SYSTEMS PVT LTD,APAC,2025-04-28,6,6,2,0,2
Waymo,United States,TRANSDEV,NORTH AMERICA,2025-05-01,7,3,4,2,2
Technical Infrastructure,null,"ROONEY HOLDINGS, INC.",NORTH AMERICA,2025-05-01,3,3,0,0,0
Technical Infrastructure,United States,GXO LOGISTICS WORLDWIDE LLC,NORTH AMERICA,2025-04-24,12,6,8,7,1
T&S,Philippines,ACCENTURE PLC,APAC,2025-04-21,3,1,2,0,2
Waymo,United States,METRO ONE LOSS PREVENTION SERVICES GROUP (GUARD DIVISION) INC,NORTH AMERICA,2025-04-23,9,4,7,7,0
Technical Infrastructure,United States,GXO LOGISTICS WORLDWIDE LLC,NORTH AMERICA,2025-04-28,4,3,1,1,0
POps,India,RANDSTAD NV,APAC,2025-05-02,7,2,5,5,0
T&S,Portugal,COGNIZANT TECHNOLOGY SOLUTIONS CORPORATION,EMEA,2025-04-24,2,2,0,0,0
gTech,India,VIRTUSA CORPORATION,APAC,2025-05-02,3,3,0,0,0
Technical Infrastructure,United States,ALLIED UNIVERSAL,NORTH AMERICA,2025-04-25,3,2,1,0,1
YouTube,India,TELEPERFORMANCE SE,APAC,2025-04-21,3,2,1,0,1
Technical Infrastructure,United States,ACCENTURE PLC,NORTH AMERICA,2025-04-21,4,3,1,0,1
gTech,Philippines,CONCENTRIX,APAC,2025-04-28,5,2,3,0,3
gCS,Philippines,CONCENTRIX,APAC,2025-05-01,3,2,1,0,1
REWS,India,SODEXO,APAC,2025-05-02,3,3,0,0,0
Cloud,United States,ACCENTURE PLC,NORTH AMERICA,2025-05-02,4,3,1,0,1
Marketing,United Kingdom,ADECCO UK LIMITED,EMEA,2025-04-30,13,26,5,3,2
YouTube,India,ACCENTURE PLC,APAC,2025-04-21,6,4,4,0,4
Access,Argentina,GLOBANT LLC,LATAM,2025-04-21,6,5,3,3,0
REWS,India,COMPASS GROUP PLC,APAC,2025-04-25,2,2,0,0,0
YouTube,India,WIPRO LIMITED,APAC,2025-05-02,3,3,0,0,0
REWS,India,JONES LANG LASALLE INC,APAC,2025-04-22,1,1,0,0,0
gTech,Sweden,"PRO UNLIMITED, INC. (VENDOR)",EMEA,2025-05-01,3,2,1,1,0
REWS,United States,FIRST,NORTH AMERICA,2025-04-27,8,1,7,5,2
Technical Infrastructure,United States,GXO LOGISTICS WORLDWIDE LLC,NORTH AMERICA,2025-04-25,6,4,4,0,4
T&S,India,WIPRO LIMITED,APAC,2025-04-23,1,1,0,0,0
Technical Infrastructure,India,EOS IT SOLUTIONS,APAC,2025-04-24,3,3,0,0,0
Waymo,United States,ABM INDUSTRIES INCORPORATED,NORTH AMERICA,2025-04-21,2,4,0,0,0
T&S,India,WIPRO LIMITED,APAC,2025-04-29,5,2,3,0,3
POps,India,RANDSTAD NV,APAC,2025-04-27,11,4,9,1,8
Cloud,United States,MANTECH ADVANCED SYSTEMS INTERNATIONAL INC,NORTH AMERICA,2025-04-22,17,5,14,0,14
POps,India,RANDSTAD NV,APAC,2025-04-25,11,null,11,1,10
X,South Korea,AVENGA INTERNATIONAL GMBH,APAC,2025-04-29,4,5,1,0,1
Waymo,United States,TRANSDEV,NORTH AMERICA,2025-04-24,7,3,4,0,4
T&S,India,WIPRO LIMITED,APAC,2025-04-25,4,1,3,1,2
REWS,India,COMPASS GROUP PLC,APAC,2025-04-21,3,5,0,0,0
Access,United States,DYCOM INDUSTRIES,NORTH AMERICA,2025-04-21,34,2,32,0,32
Cloud,Bulgaria,TELUS,EMEA,2025-04-30,2,1,1,1,0
POps,India,RANDSTAD NV,APAC,2025-04-23,7,2,5,4,1
REWS,United States,LUX BUS AMERICA CO,NORTH AMERICA,2025-04-28,3,5,0,0,0
Ads & Commerce,United States,"AKRAYA, INC",NORTH AMERICA,2025-04-30,5,2,3,0,3
Cloud,United States,"Probity, Inc",NORTH AMERICA,2025-04-21,2,1,1,1,0
Corp Eng,India,HCL TECHNOLOGIES LTD,APAC,2025-04-29,2,3,1,0,1
Technical Infrastructure,United States,"INTELLISWIFT SOFTWARE, INC",NORTH AMERICA,2025-04-22,5,6,1,0,1
T&S,India,COGNIZANT TECHNOLOGY SOLUTIONS CORPORATION,APAC,2025-04-27,8,6,4,1,3
Technical Infrastructure,United States,"HOLDER CONSTRUCTION GROUP, LLC",NORTH AMERICA,2025-04-29,1,1,0,0,0
REWS,United States,COMPASS GROUP PLC,NORTH AMERICA,2025-04-23,2,2,0,0,0
POps,India,RANDSTAD NV,APAC,2025-04-30,5,6,1,0,1
Technical Infrastructure,United States,SCHENKER,NORTH AMERICA,2025-04-24,3,3,0,0,0
Technical Infrastructure,United States,DIRECT LINE GLOBAL LLC,NORTH AMERICA,2025-04-29,2,4,0,0,0
Cloud,Greece,TELEPERFORMANCE SE,EMEA,2025-04-29,3,5,0,0,0
YouTube,United States,COLLABERA LLC,NORTH AMERICA,2025-05-01,9,10,4,0,4
Technical Infrastructure,United States,E2 OPTICS,NORTH AMERICA,2025-05-01,16,5,13,12,1
REWS,null,CBRE GROUP INC,EMEA,2025-04-25,3,3,0,0,0
REWS,India,COMPASS GROUP PLC,APAC,2025-04-25,2,2,0,0,0
T&S,India,ACCENTURE PLC,APAC,2025-04-22,7,3,6,0,6
gTech,India,TELEPERFORMANCE SE,APAC,2025-04-28,5,3,2,2,0
T&S,India,COGNIZANT TECHNOLOGY SOLUTIONS CORPORATION,APAC,2025-04-23,4,1,3,1,2
Technical Infrastructure,United Kingdom,SYNERGY SECURITY SOLUTIONS LIMITED,EMEA,2025-04-25,3,1,2,1,1
Devices & Services,India,CAPGEMINI SE,APAC,2025-04-21,4,1,3,3,0
Technical Infrastructure,United States,"AKRAYA, INC",NORTH AMERICA,2025-05-02,7,5,4,3,1
Corp Eng,United States,IBM CORPORATION,NORTH AMERICA,2025-04-21,10,3,7,7,0
Waymo,India,COGNIZANT TECHNOLOGY SOLUTIONS CORPORATION,APAC,2025-04-21,1,3,0,0,0
GBO (w/o gTech & gCS),Singapore,CODIMITE PTE LTD,APAC,2025-04-30,2,2,0,0,0
REWS,United Kingdom,FIRST,EMEA,2025-05-02,6,5,0,0,0
Technical Infrastructure,United States,TURNER & TOWNSEND PARTNERS LLP,NORTH AMERICA,2025-04-23,4,1,3,0,3
gTech,India,COGNIZANT TECHNOLOGY SOLUTIONS CORPORATION,APAC,2025-04-29,4,5,1,1,0
gTech,Portugal,COGNIZANT TECHNOLOGY SOLUTIONS CORPORATION,EMEA,2025-04-30,4,5,1,0,1
T&S,India,ACCENTURE PLC,APAC,2025-04-21,11,5,8,1,7
Waymo,India,COGNIZANT TECHNOLOGY SOLUTIONS CORPORATION,APAC,2025-05-01,3,2,1,0,1
Technical Infrastructure,United States,GXO LOGISTICS WORLDWIDE LLC,NORTH AMERICA,2025-04-24,10,4,8,8,0
Waymo,United States,TRANSDEV,NORTH AMERICA,2025-04-25,8,2,6,0,6
REWS,India,JONES LANG LASALLE INC,APAC,2025-04-23,2,2,0,0,0
Technical Infrastructure,United States,GARDA WORLD SECURITY CORPORATION,NORTH AMERICA,2025-04-24,3,2,1,0,1
gTech,India,TECH MAHINDRA LIMITED,APAC,2025-04-27,3,2,1,1,0
Corp Eng,India,AGIVANT TECHNOLOGIES INC,APAC,2025-04-21,2,1,1,1,0
Technical Infrastructure,Australia,MSS SECURITY PTY LTD,APAC,2025-04-22,6,2,4,3,1
gTech,India,TECH MAHINDRA LIMITED,APAC,2025-04-23,2,1,1,1,0
gTech,India,COGNIZANT TECHNOLOGY SOLUTIONS CORPORATION,APAC,2025-04-23,2,1,1,1,0
POps,India,ACCENTURE PLC,APAC,2025-04-22,5,1,4,1,3
Ads & Commerce,India,TELEPERFORMANCE SE,APAC,2025-04-23,5,1,4,2,2
Technical Infrastructure,United States,GXO LOGISTICS WORLDWIDE LLC,NORTH AMERICA,2025-04-28,4,2,2,0,2
Cloud,India,INFOSYS,APAC,2025-04-30,3,5,0,0,0
YouTube,India,ACCENTURE PLC,APAC,2025-04-23,4,1,3,0,3
gTech,Germany,VACO,EMEA,2025-04-21,3,1,2,1,1
Finance,United States,ERNST AND YOUNG LLP,NORTH AMERICA,2025-05-01,5,4,3,2,1
T&S,Philippines,ACCENTURE PLC,APAC,2025-05-02,3,3,0,0,0
gTech,India,TELEPERFORMANCE SE,APAC,2025-04-21,4,1,3,0,3
Technical Infrastructure,United States,ANCHORBUOY LIMITED,NORTH AMERICA,2025-04-22,4,5,1,0,1
Waymo,India,COGNIZANT TECHNOLOGY SOLUTIONS CORPORATION,APAC,2025-04-21,1,3,0,0,0
YouTube,Portugal,GENPACT LIMITED,EMEA,2025-04-22,4,1,3,2,1
gCS,India,REGALIX INC,APAC,2025-04-25,4,3,1,1,0
Technical Infrastructure,United Kingdom,GLEAVE PARTNERSHIP LIMITED,EMEA,2025-05-02,11,6,7,0,7
T&S,India,WIPRO LIMITED,APAC,2025-04-21,4,1,3,1,2
Technical Infrastructure,United States,ADECCO GROUP AG,NORTH AMERICA,2025-04-27,8,6,5,0,5
Access,United States,DYCOM INDUSTRIES,NORTH AMERICA,2025-04-23,6,1,5,4,1
gTech,India,VIRTUSA CORPORATION,APAC,2025-04-25,3,3,0,0,0
REWS,India,COMPASS GROUP PLC,APAC,2025-04-25,2,2,0,0,0
Waymo,United States,"TASKUS, INC.",NORTH AMERICA,2025-04-25,8,7,3,2,1
gTech,Poland,TELEPERFORMANCE SE,EMEA,2025-04-28,3,5,0,0,0
T&S,India,CONCENTRIX,APAC,2025-04-21,3,2,1,1,0
T&S,India,COGNIZANT TECHNOLOGY SOLUTIONS CORPORATION,APAC,2025-04-22,2,3,1,0,1
Technical Infrastructure,United States,"CBM OF AMERICA, INC. (VENDOR)",NORTH AMERICA,2025-04-22,4,6,0,0,0
T&S,India,WIPRO LIMITED,APAC,2025-04-29,5,1,4,0,4
T&S,India,WIPRO LIMITED,APAC,2025-04-23,4,1,3,1,2
T&S,India,ACCENTURE PLC,APAC,2025-04-25,4,2,2,1,1
Technical Infrastructure,United States,SCHENKER,NORTH AMERICA,2025-04-28,5,3,2,0,2
Waymo,United States,AMERIT FLEET SOLUTIONS INC.,NORTH AMERICA,2025-04-28,2,1,1,0,1
REWS,United States,JONES LANG LASALLE INC,NORTH AMERICA,2025-04-29,4,6,0,0,0
Technical Infrastructure,United States,"ROONEY HOLDINGS, INC.",NORTH AMERICA,2025-04-29,3,5,0,0,0
REWS,United States,COMPASS GROUP PLC,NORTH AMERICA,2025-04-22,1,1,0,0,0
T&S,India,WIPRO LIMITED,APAC,2025-05-02,4,3,1,0,1
gCS,India,REGALIX INC,APAC,2025-04-25,4,3,1,1,0
gTech,India,COGNIZANT TECHNOLOGY SOLUTIONS CORPORATION,APAC,2025-04-21,9,2,7,6,1
gTech,India,TELEPERFORMANCE SE,APAC,2025-04-22,5,1,4,1,3
Cloud,Mexico,TATA GROUP,LATAM,2025-04-28,4,2,2,2,0
POps,India,ACCENTURE PLC,APAC,2025-04-23,9,1,8,1,7
Devices & Services,United States,ACCENTURE PLC,NORTH AMERICA,2025-04-28,7,5,4,2,2
Waymo,United States,AUTONATION,NORTH AMERICA,2025-04-21,2,1,1,0,1
T&S,India,WIPRO LIMITED,APAC,2025-05-02,3,3,0,0,0
Geo,India,ACCENTURE PLC,APAC,2025-04-25,5,4,3,1,2
T&S,India,WIPRO LIMITED,APAC,2025-04-25,3,1,2,0,2
Technical Infrastructure,null,"CBM OF AMERICA, INC. (VENDOR)",NORTH AMERICA,2025-04-29,3,5,0,0,0
Technical Infrastructure,United States,GARDA WORLD SECURITY CORPORATION,NORTH AMERICA,2025-04-24,3,3,0,0,0
Devices & Services,United States,ARCHLYNK LLC,NORTH AMERICA,2025-04-28,7,4,5,0,5
YouTube,Portugal,GENPACT LIMITED,EMEA,2025-04-30,7,3,4,3,1
Waymo,India,WIPRO LIMITED,APAC,2025-04-30,2,1,1,0,1
Ads & Commerce,India,TELEPERFORMANCE SE,APAC,2025-04-23,5,1,4,2,2
gCS,India,WNS (HOLDINGS) LIMITED,APAC,2025-04-24,3,2,1,1,0
Search,India,GLOBALLOGIC INC,APAC,2025-05-01,2,3,0,0,0
Waymo,India,WIPRO LIMITED,APAC,2025-05-01,3,3,0,0,0
REWS,United States,ELECTROSONIC LIMITED,NORTH AMERICA,2025-04-22,3,5,0,0,0
Waymo,India,COGNIZANT TECHNOLOGY SOLUTIONS CORPORATION,APAC,2025-04-21,1,3,0,0,0
Technical Infrastructure,Finland,ADECCO GROUP AG,EMEA,2025-04-24,7,6,3,3,0
T&S,Malaysia,ACCENTURE PLC,APAC,2025-04-29,3,4,1,0,1
Waymo,United States,TRANSDEV,NORTH AMERICA,2025-04-24,7,1,6,0,6
REWS,India,JONES LANG LASALLE INC,APAC,2025-05-02,3,3,0,0,0
REWS,null,COMPASS GROUP PLC,NORTH AMERICA,2025-04-24,3,3,0,0,0
Technical Infrastructure,United States,GXO LOGISTICS WORLDWIDE LLC,NORTH AMERICA,2025-04-24,2,2,0,0,0
gTech,India,ACCENTURE PLC,APAC,2025-04-25,2,1,1,0,1
Technical Infrastructure,United States,SCHENKER,NORTH AMERICA,2025-04-24,3,3,0,0,0
gTech,Poland,TELEPERFORMANCE SE,EMEA,2025-04-28,3,5,0,0,0
Corp Eng,India,IBM CORPORATION,APAC,2025-04-22,3,1,2,0,2
gTech,India,COGNIZANT TECHNOLOGY SOLUTIONS CORPORATION,APAC,2025-05-02,4,3,1,0,1
Cloud,India,DELOITTE,APAC,2025-04-23,3,3,2,1,1
gTech,India,ACCENTURE PLC,APAC,2025-04-22,6,2,4,0,4
Geo,India,ACCENTURE PLC,APAC,2025-05-01,17,1,16,0,16
REWS,India,G4S PLC,APAC,2025-04-24,1,1,0,0,0
Technical Infrastructure,United States,GXO LOGISTICS WORLDWIDE LLC,NORTH AMERICA,2025-04-30,6,2,4,4,0
gTech,Germany,VACO,EMEA,2025-04-21,3,5,0,0,0
Waymo,India,COGNIZANT TECHNOLOGY SOLUTIONS CORPORATION,APAC,2025-05-01,3,3,0,0,0
Cloud,India,HCL TECHNOLOGIES LTD,APAC,2025-04-23,2,1,1,0,1
REWS,Finland,CBRE GROUP INC,EMEA,2025-05-02,3,3,0,0,0
T&S,Philippines,ACCENTURE PLC,APAC,2025-04-24,2,2,0,0,0
REWS,India,G4S PLC,APAC,2025-05-01,3,3,0,0,0
POps,India,RANDSTAD NV,APAC,2025-04-28,12,4,10,4,6
Marketing,India,FRACTAL ANALYTICS PRIVATE LIMITED,APAC,2025-04-24,2,2,0,0,0
Waymo,United States,"TASKUS, INC.",NORTH AMERICA,2025-04-22,14,2,12,0,12
Technical Infrastructure,United States,SCHENKER,NORTH AMERICA,2025-04-28,3,5,0,0,0
Corp Eng,Poland,ASTREYA PARTNERS INC,EMEA,2025-04-22,3,1,2,1,1
T&S,Philippines,ACCENTURE PLC,APAC,2025-04-24,5,6,1,1,0
Technical Infrastructure,United States,GARDA WORLD SECURITY CORPORATION,NORTH AMERICA,2025-05-01,3,1,2,0,2
Access,Ireland,ADECCO IRELAND LIMITED,EMEA,2025-04-22,5,4,2,0,2
REWS,India,JONES LANG LASALLE INC,APAC,2025-05-02,3,3,0,0,0
Waymo,India,WIPRO LIMITED,APAC,2025-05-01,3,2,1,0,1
Waymo,India,COGNIZANT TECHNOLOGY SOLUTIONS CORPORATION,APAC,2025-04-21,1,3,0,0,0
gCS,Canada,TELEPERFORMANCE SE,NORTH AMERICA,2025-04-29,4,5,1,1,0
Technical Infrastructure,United States,GXO LOGISTICS WORLDWIDE LLC,NORTH AMERICA,2025-04-21,2,4,0,0,0
gTech,Philippines,TELUS,APAC,2025-04-22,2,4,0,0,0
T&S,India,WIPRO LIMITED,APAC,2025-04-30,5,7,0,0,0
Technical Infrastructure,United Kingdom,LOMBARDIA CONSULTING GROUP,EMEA,2025-04-28,7,4,5,0,5
Waymo,India,WIPRO LIMITED,APAC,2025-05-01,3,3,0,0,0
T&S,Romania,COGNIZANT TECHNOLOGY SOLUTIONS CORPORATION,EMEA,2025-05-03,4,3,1,0,1
gTech,India,HCL TECHNOLOGIES LTD,APAC,2025-04-27,6,3,5,1,4
T&S,India,WIPRO LIMITED,APAC,2025-05-01,4,5,1,1,0
REWS,United States,SUREFOX CONSULTING LLC,NORTH AMERICA,2025-04-28,3,1,2,0,2
Geo,India,WIPRO LIMITED,APAC,2025-04-23,2,3,0,0,0
REWS,United States,JONES LANG LASALLE INC,NORTH AMERICA,2025-04-25,2,2,0,0,0
gTech,Mexico,QUALITEST,LATAM,2025-04-28,4,3,1,0,1
REWS,United States,COMPASS GROUP PLC,NORTH AMERICA,2025-05-02,9,1,8,0,8
gTech,Philippines,ALORICA INC,APAC,2025-04-21,3,1,2,2,0
Corp Eng,Poland,ASTREYA PARTNERS INC,EMEA,2025-04-25,3,3,0,0,0
YouTube,India,ACCENTURE PLC,APAC,2025-04-21,6,3,5,1,4
T&S,India,WIPRO LIMITED,APAC,2025-04-23,4,4,2,0,2
Technical Infrastructure,Belgium,SECURITAS AB,EMEA,2025-04-28,3,2,1,1,0
Cloud,Taiwan,ALIZ TECHNOLOGIES PTE LTD,APAC,2025-04-23,3,4,1,1,0
REWS,India,JONES LANG LASALLE INC,APAC,2025-05-02,3,3,0,0,0
Waymo,United States,MAGNA INTERNATIONAL INC.,NORTH AMERICA,2025-04-28,5,4,1,0,1
Technical Infrastructure,United States,INSIGHT,NORTH AMERICA,2025-04-29,5,2,3,3,0
Technical Infrastructure,Denmark,QVISTGAARD IS,EMEA,2025-05-01,3,4,0,0,0
Global Affairs (w/o T&S),India,ACCENTURE PLC,APAC,2025-05-02,4,3,1,1,0
DeepMind,United States,SCALE AI INC,NORTH AMERICA,2025-04-22,17,5,14,1,13
Technical Infrastructure,Singapore,NIPPON TELEGRAPH AND TELEPHONE CORPORATION,APAC,2025-05-02,3,3,0,0,0
Access,United States,DYCOM INDUSTRIES,NORTH AMERICA,2025-04-28,8,2,6,6,0
T&S,India,WIPRO LIMITED,APAC,2025-04-21,4,6,0,0,0
REWS,Taiwan,EXOS,APAC,2025-04-25,2,2,0,0,0
Technical Infrastructure,India,VERBESTEL LLC,APAC,2025-04-29,19,2,17,1,16
YouTube,India,CONCENTRIX,APAC,2025-04-21,3,2,1,0,1
YouTube,Philippines,TECH MAHINDRA LIMITED,APAC,2025-05-02,11,1,10,0,10
Finance,United States,PWC,NORTH AMERICA,2025-04-25,12,2,10,7,3
gCS,India,WNS (HOLDINGS) LIMITED,APAC,2025-04-24,3,1,2,1,1
Technical Infrastructure,United States,GARDA WORLD SECURITY CORPORATION,NORTH AMERICA,2025-04-25,4,1,3,1,2
gTech,United States,VACO,NORTH AMERICA,2025-04-21,3,1,2,0,2
Platforms + Ecosystems,United States,HCL TECHNOLOGIES LTD,NORTH AMERICA,2025-04-22,6,3,3,2,1
Geo,India,WIPRO LIMITED,APAC,2025-04-23,2,1,1,0,1
Waymo,United States,METRO ONE LOSS PREVENTION SERVICES GROUP (GUARD DIVISION) INC,NORTH AMERICA,2025-04-21,7,4,5,4,1
Geo,India,WIPRO LIMITED,APAC,2025-04-28,2,4,0,0,0
T&S,India,WIPRO LIMITED,APAC,2025-04-30,5,2,3,1,2
Cloud,India,UBER TECHNOLOGIES INC,APAC,2025-04-23,3,3,2,2,0
YouTube,India,WIPRO LIMITED,APAC,2025-04-24,3,2,2,2,0
T&S,Japan,ADECCO GROUP AG,APAC,2025-04-21,4,3,1,1,0
T&S,Philippines,ACCENTURE PLC,APAC,2025-04-28,9,3,6,1,5
REWS,Japan,JONES LANG LASALLE INC,APAC,2025-04-22,5,3,2,0,2
Platforms + Ecosystems,India,ENCORA HOLDINGS LIMITED,APAC,2025-04-30,3,3,2,0,2
gTech,India,TELEPERFORMANCE SE,APAC,2025-04-21,4,1,3,1,2
gCS,India,TELEDIRECT PTE LTD,APAC,2025-04-23,2,2,0,0,0
gCS,India,TELEDIRECT PTE LTD,APAC,2025-04-24,3,2,1,1,0
Waymo,United States,AUTONATION,NORTH AMERICA,2025-04-24,3,3,0,0,0
Cloud,India,WEBHELP GROUP,APAC,2025-04-22,5,6,1,0,1
Devices & Services,India,VIRTUSA CORPORATION,APAC,2025-04-22,5,2,3,2,1
REWS,India,COMPASS GROUP PLC,APAC,2025-04-23,2,2,0,0,0
gTech,Portugal,TELEPERFORMANCE SE,EMEA,2025-04-21,6,5,3,1,2
REWS,Belgium,CBRE GROUP INC,EMEA,2025-04-30,1,1,0,0,0
Waymo,India,COGNIZANT TECHNOLOGY SOLUTIONS CORPORATION,APAC,2025-04-23,1,1,0,0,0
REWS,India,COMPASS GROUP PLC,APAC,2025-04-21,2,4,0,0,0
T&S,India,WIPRO LIMITED,APAC,2025-04-30,3,5,0,0,0
T&S,United States,PWC,NORTH AMERICA,2025-04-30,2,2,0,0,0
Technical Infrastructure,United Kingdom,GXO LOGISTICS WORLDWIDE LLC,EMEA,2025-04-22,5,2,3,0,3
YouTube,India,ACCENTURE PLC,APAC,2025-04-24,5,1,4,1,3
Technical Infrastructure,United States,SYNCREON GLOBAL HOLDINGS LIMITED,NORTH AMERICA,2025-04-29,15,6,11,1,10
gCS,India,ACCENTURE PLC,APAC,2025-04-30,6,6,2,1,1
Devices & Services,United States,ACCENTURE PLC,NORTH AMERICA,2025-04-22,2,3,1,0,1
Technical Infrastructure,United States,TW CONSTRUCTORS LLC,NORTH AMERICA,2025-04-30,9,5,6,6,0
Technical Infrastructure,United States,SCHENKER,NORTH AMERICA,2025-04-22,9,8,3,1,2
Waymo,India,WIPRO LIMITED,APAC,2025-04-24,3,1,2,0,2
Technical Infrastructure,United States,C D MOODY CONSTRUCTION COMPANY INC,NORTH AMERICA,2025-04-24,3,3,0,0,0
Geo,India,WIPRO LIMITED,APAC,2025-04-28,3,2,1,1,0
Technical Infrastructure,Finland,FIBER HIGHWAY FINLAND OY,EMEA,2025-04-29,3,5,0,0,0
gTech,India,VIRTUSA CORPORATION,APAC,2025-04-25,3,2,1,0,1
Waymo,United States,METRO ONE LOSS PREVENTION SERVICES GROUP (GUARD DIVISION) INC,NORTH AMERICA,2025-04-22,7,4,5,0,5
YouTube,Poland,ANTMICRO SP Z O O,EMEA,2025-04-25,2,1,1,0,1
Technical Infrastructure,United States,"CBM OF AMERICA, INC. (VENDOR)",NORTH AMERICA,2025-04-23,2,2,0,0,0
Devices & Services,India,HCL TECHNOLOGIES LTD,APAC,2025-04-27,6,null,6,1,5
Technical Infrastructure,United States,GXO LOGISTICS WORLDWIDE LLC,NORTH AMERICA,2025-04-28,4,2,2,0,2
Technical Infrastructure,null,TW CONSTRUCTORS LLC,NORTH AMERICA,2025-04-22,3,5,0,0,0
Platforms + Ecosystems,Philippines,NCC GROUP,APAC,2025-05-02,4,2,2,0,2
Platforms + Ecosystems,United States,MAGIC LEAP INC.,NORTH AMERICA,2025-04-29,8,4,6,0,6
T&S,Malaysia,ACCENTURE PLC,APAC,2025-04-24,11,2,9,8,1
gCS,India,ACCENTURE PLC,APAC,2025-04-30,15,5,12,12,0
gCS,India,TELEDIRECT PTE LTD,APAC,2025-04-24,8,3,5,4,1
Waymo,United States,METRO ONE LOSS PREVENTION SERVICES GROUP (GUARD DIVISION) INC,NORTH AMERICA,2025-05-01,5,5,2,2,0
gTech,India,CONCENTRIX,APAC,2025-04-21,8,2,6,6,0
Waymo,United States,COGNIZANT TECHNOLOGY SOLUTIONS CORPORATION,NORTH AMERICA,2025-04-30,8,3,7,6,1
Technical Infrastructure,Netherlands,SYNCREON GLOBAL HOLDINGS LIMITED,EMEA,2025-04-29,5,2,3,2,1
POps,India,ACCENTURE PLC,APAC,2025-04-21,5,1,4,1,3
REWS,India,JONES LANG LASALLE INC,APAC,2025-04-23,1,1,0,0,0
T&S,Romania,WEBHELP GROUP,EMEA,2025-04-24,6,2,4,4,0
Technical Infrastructure,United States,ALLIED UNIVERSAL,NORTH AMERICA,2025-04-24,9,4,7,6,1
Technical Infrastructure,United States,DIRECT LINE GLOBAL LLC,NORTH AMERICA,2025-04-28,3,5,0,0,0
T&S,India,ACCENTURE PLC,APAC,2025-04-21,4,1,3,1,2
REWS,India,COMPASS GROUP PLC,APAC,2025-04-22,4,6,0,0,0
REWS,India,JONES LANG LASALLE INC,APAC,2025-05-02,3,3,0,0,0
gTech,Malaysia,TELEDIRECT PTE LTD,APAC,2025-04-21,2,1,1,0,1
Technical Infrastructure,Finland,FIBER HIGHWAY FINLAND OY,EMEA,2025-04-25,3,1,2,0,2
gTech,India,COGNIZANT TECHNOLOGY SOLUTIONS CORPORATION,APAC,2025-04-27,3,2,1,0,1
Geo,null,PWC,NORTH AMERICA,2025-05-01,3,3,0,0,0
T&S,India,WIPRO LIMITED,APAC,2025-04-30,5,2,3,2,1
YouTube,India,COGNIZANT TECHNOLOGY SOLUTIONS CORPORATION,APAC,2025-05-02,3,3,0,0,0
Technical Infrastructure,United States,"AKRAYA, INC",NORTH AMERICA,2025-04-22,3,5,0,0,0
Corp Eng,India,ACCENTURE PLC,APAC,2025-04-29,3,4,1,0,1
REWS,India,COMPASS GROUP PLC,APAC,2025-04-25,2,2,0,0,0
POps,China,ACCENTURE PLC,APAC,2025-04-21,11,4,9,0,9
T&S,Philippines,ACCENTURE PLC,APAC,2025-04-29,10,3,7,1,6
YouTube,United States,TELEPERFORMANCE SE,NORTH AMERICA,2025-04-30,5,6,1,0,1
Technical Infrastructure,United States,SCHENKER,NORTH AMERICA,2025-04-28,4,6,0,0,0
Technical Infrastructure,United States,"HOLDER CONSTRUCTION GROUP, LLC",NORTH AMERICA,2025-04-28,4,6,0,0,0
Waymo,India,WIPRO LIMITED,APAC,2025-04-24,3,4,0,0,0
gTech,India,COGNIZANT TECHNOLOGY SOLUTIONS CORPORATION,APAC,2025-04-22,2,4,0,0,0
gCS,Brazil,TTEC HOLDINGS INC,LATAM,2025-04-28,5,4,1,0,1
Ads & Commerce,India,GLOBALLOGIC INC,APAC,2025-04-28,7,5,4,0,4
Waymo,India,COGNIZANT TECHNOLOGY SOLUTIONS CORPORATION,APAC,2025-05-02,4,3,1,1,0
Technical Infrastructure,United States,"ROONEY HOLDINGS, INC.",NORTH AMERICA,2025-04-22,4,2,2,0,2
Finance,United States,ERNST AND YOUNG LLP,NORTH AMERICA,2025-04-23,7,2,5,5,0
Technical Infrastructure,United States,"ROONEY HOLDINGS, INC.",NORTH AMERICA,2025-04-24,3,5,0,0,0
REWS,India,COMPASS GROUP PLC,APAC,2025-04-25,2,2,0,0,0
Devices & Services,India,WIPRO LIMITED,APAC,2025-04-24,9,4,7,0,7
Access,United States,INSIGHT,NORTH AMERICA,2025-04-23,8,4,6,6,0
REWS,United States,GARDA WORLD SECURITY CORPORATION,NORTH AMERICA,2025-04-28,7,4,5,4,1
Platforms + Ecosystems,India,HCL TECHNOLOGIES LTD,APAC,2025-04-29,4,5,1,1,0
Cloud,Mexico,EPAM SYSTEMS INC,LATAM,2025-04-29,4,2,2,2,0
Technical Infrastructure,United States,"HOLDER CONSTRUCTION GROUP, LLC",NORTH AMERICA,2025-04-23,3,5,0,0,0
Technical Infrastructure,United States,GXO LOGISTICS WORLDWIDE LLC,NORTH AMERICA,2025-04-24,2,2,0,0,0
REWS,United States,SYSTEM ONE HOLDINGS LLC DBA TEAMPEOPLE,NORTH AMERICA,2025-05-02,56,5,53,1,52
Cloud,United States,"WORLD WIDE TECHNOLOGY HOLDING CO., LLC",NORTH AMERICA,2025-04-24,6,5,3,2,1
Technical Infrastructure,Finland,FIBER HIGHWAY FINLAND OY,EMEA,2025-04-24,2,1,1,1,0
YouTube,Ireland,ACCENTURE PLC,EMEA,2025-04-25,6,5,3,2,1
Cloud,India,QUANTIPHI INC,APAC,2025-04-23,9,6,5,0,5
Technical Infrastructure,United States,SCHENKER,NORTH AMERICA,2025-04-29,6,3,3,3,0
YouTube,India,CONCENTRIX,APAC,2025-04-29,5,3,2,1,1
Access,Canada,LYNX PLANNING & ENGINEERING INC,NORTH AMERICA,2025-04-25,4,1,3,0,3
Ads & Commerce,India,TELEPERFORMANCE SE,APAC,2025-04-24,1,null,1,0,1
Technical Infrastructure,United States,DIRECT LINE GLOBAL LLC,NORTH AMERICA,2025-04-28,1,3,0,0,0
T&S,India,WIPRO LIMITED,APAC,2025-04-21,4,1,3,1,2
Technical Infrastructure,United States,MCFARLAND BUILDING GROUP LLC,NORTH AMERICA,2025-05-01,3,3,0,0,0
gTech,India,COGNIZANT TECHNOLOGY SOLUTIONS CORPORATION,APAC,2025-05-01,3,3,0,0,0
YouTube,India,TELEPERFORMANCE SE,APAC,2025-04-23,5,5,2,2,0
Technical Infrastructure,United States,SCHENKER,NORTH AMERICA,2025-04-25,2,2,0,0,0
Cloud,United States,GLOBALLOGIC INC,NORTH AMERICA,2025-04-25,2,1,1,0,1
Technical Infrastructure,United States,IRON SYSTEMS INC,NORTH AMERICA,2025-04-29,9,2,7,7,0
Waymo,India,COGNIZANT TECHNOLOGY SOLUTIONS CORPORATION,APAC,2025-04-21,1,3,0,0,0
POps,India,ACCENTURE PLC,APAC,2025-04-29,2,3,1,0,1
Access,United States,ITC SERVICE GROUP ACQUISITION LLC,NORTH AMERICA,2025-05-02,5,5,2,2,0
Technical Infrastructure,United States,SCHENKER,NORTH AMERICA,2025-05-01,8,3,5,5,0
Technical Infrastructure,null,INDIGO TELECOM GROUP LTD,LATAM,2025-05-01,3,3,0,0,0
Technical Infrastructure,India,ADANICONNEX,APAC,2025-04-21,1,3,0,0,0
gTech,India,TECH MAHINDRA LIMITED,APAC,2025-04-28,3,5,0,0,0
YouTube,India,WIPRO LIMITED,APAC,2025-05-01,3,3,0,0,0
gTech,India,COGNIZANT TECHNOLOGY SOLUTIONS CORPORATION,APAC,2025-05-02,3,3,0,0,0
Cloud,El Salvador,SERVICESOURCE INTERNATIONAL INC,LATAM,2025-04-28,3,5,0,0,0
Technical Infrastructure,Ireland,ANCHORBUOY LIMITED,EMEA,2025-04-29,2,4,0,0,0
Waymo,United States,METRO ONE LOSS PREVENTION SERVICES GROUP (GUARD DIVISION) INC,NORTH AMERICA,2025-04-28,2,4,0,0,0
REWS,India,JONES LANG LASALLE INC,APAC,2025-04-22,1,1,0,0,0
REWS,null,MEDIFIT CONSULTANTS PVT LTD,APAC,2025-05-02,3,3,0,0,0
Waymo,India,WIPRO LIMITED,APAC,2025-04-24,3,2,2,2,0
T&S,Portugal,COGNIZANT TECHNOLOGY SOLUTIONS CORPORATION,EMEA,2025-04-22,6,1,5,4,1
Platforms + Ecosystems,United States,DELOITTE,NORTH AMERICA,2025-04-30,3,3,2,0,2
GBO (w/o gTech & gCS),Poland,TTEC HOLDINGS INC,EMEA,2025-04-28,3,1,2,2,0
Waymo,India,WIPRO LIMITED,APAC,2025-04-21,2,1,1,1,0
Global Affairs (w/o T&S),United States,MORRISON & FOERSTER LLP,NORTH AMERICA,2025-05-01,6,5,3,0,3
T&S,India,WIPRO LIMITED,APAC,2025-04-28,7,4,5,5,0
REWS,India,COMPASS GROUP PLC,APAC,2025-04-25,2,2,0,0,0
gCS,India,REGALIX INC,APAC,2025-04-27,5,3,2,2,0
gCS,India,WNS (HOLDINGS) LIMITED,APAC,2025-04-24,3,1,2,1,1
REWS,null,COMPASS GROUP PLC,APAC,2025-04-21,3,5,0,0,0
Waymo,India,WIPRO LIMITED,APAC,2025-04-30,6,1,5,5,0
DeepMind,United Kingdom,SMARTPA GLOBAL LTD,EMEA,2025-04-30,17,3,14,2,12
Finance,India,IBM CORPORATION,APAC,2025-04-29,8,1,7,5,2
Geo,India,WIPRO LIMITED,APAC,2025-04-24,1,1,0,0,0
Technical Infrastructure,United States,GARDA WORLD SECURITY CORPORATION,NORTH AMERICA,2025-04-25,4,3,1,0,1
Technical Infrastructure,United States,SYNCREON GLOBAL HOLDINGS LIMITED,NORTH AMERICA,2025-05-02,11,1,10,5,5
Waymo,United States,TRANSDEV,NORTH AMERICA,2025-04-25,2,2,0,0,0
Technical Infrastructure,Israel,ASTREYA PARTNERS INC,EMEA,2025-04-24,3,3,0,0,0
Geo,India,WIPRO LIMITED,APAC,2025-04-24,3,2,1,0,1
REWS,United States,GARDA WORLD SECURITY CORPORATION,NORTH AMERICA,2025-05-02,6,4,4,1,3
REWS,United States,COMPASS GROUP PLC,NORTH AMERICA,2025-04-30,2,2,0,0,0
REWS,United States,FIRST,NORTH AMERICA,2025-04-21,3,1,2,0,2
REWS,India,G4S PLC,APAC,2025-04-24,1,1,0,0,0
REWS,United States,MC DEAN INC,NORTH AMERICA,2025-04-24,7,7,2,0,2
Technical Infrastructure,United States,GXO LOGISTICS WORLDWIDE LLC,NORTH AMERICA,2025-04-25,8,2,6,0,6
YouTube,Greece,TELEPERFORMANCE SE,EMEA,2025-05-02,4,3,1,1,0
Technical Infrastructure,null,EVERGREEN JANITORIAL SERVICES INC,NORTH AMERICA,2025-04-25,3,3,0,0,0
gCS,India,TELEDIRECT PTE LTD,APAC,2025-04-24,3,2,1,1,0
Other Bets,Singapore,SCALENCE LLC,APAC,2025-04-23,7,7,2,2,0
Marketing,United States,LUCKY DAY LLC,NORTH AMERICA,2025-04-23,7,2,5,4,1
Geo,India,WIPRO LIMITED,APAC,2025-04-22,1,1,0,0,0
gTech,India,COGNIZANT TECHNOLOGY SOLUTIONS CORPORATION,APAC,2025-04-30,4,5,1,0,1
T&S,Portugal,COGNIZANT TECHNOLOGY SOLUTIONS CORPORATION,EMEA,2025-04-22,6,3,3,2,1
T&S,Philippines,ACCENTURE PLC,APAC,2025-04-21,5,2,3,0,3
REWS,null,JOHNSON CONTROLS INTERNATIONAL PLC,NORTH AMERICA,2025-04-23,3,5,0,0,0
Waymo,India,WIPRO LIMITED,APAC,2025-05-01,3,1,2,0,2
Access,United States,DYCOM INDUSTRIES,NORTH AMERICA,2025-04-22,9,5,6,1,5
POps,India,RANDSTAD NV,APAC,2025-04-30,10,1,9,2,7
gTech,United States,VACO,NORTH AMERICA,2025-04-28,3,1,2,0,2
Technical Infrastructure,Indonesia,G4S PLC,APAC,2025-04-22,1,2,0,0,0
T&S,India,WIPRO LIMITED,APAC,2025-04-30,3,5,0,0,0
REWS,India,SODEXO,APAC,2025-05-02,3,3,0,0,0
Technical Infrastructure,Finland,GXO LOGISTICS WORLDWIDE LLC,EMEA,2025-04-22,5,3,2,1,1
